"hotel","fecha_ocupacion","numero_de_habitaciones","venta_por_alojamiento","numero_de_habitaciones_reservas","venta_por_alojamiento_reservas","dif_ocup","dif_ingresos","dif_ocup_porc","dif_ingresos_porc","flag_anomalia"
"SLA","1/1/2018","53","14913","0","0","-53","-14913","-1","-1","1"
"SLA","2/1/2018","59","16585","2","569","-57","-16016","-0.966101694","-0.9656918902622852","1"
"SLA","3/1/2018","62","17173","6","1785","-56","-15388","-0.903225806","-0.8960577650963722","1"
"SLA","4/1/2018","58","14694","5","90237","-53","75543","-0.913793103","5.141077991016742","1"
"SLA","5/1/2018","49","13637","7","2297","-42","-11340","-0.857142857","-0.8315611938109555","1"
"SLA","6/1/2018","57","16688","5","1504","-52","-15184","-0.912280701","-0.909875359539789","1"
"SLA","7/1/2018","61","16896","4","1347","-57","-15549","-0.934426229","-0.9202769886363636","1"
"SLA","8/1/2018","62","17265","13","3532","-49","-13733","-0.79032258","-0.79542426875181","1"
"SLA","9/1/2018","53","14764","7","2252","-46","-12512","-0.867924528","-0.8474668111622866","1"
"SLA","10/1/2018","55","13541","8","91255","-47","77714","-0.854545454","5.739162543386751","1"
"SLA","11/1/2018","57","13643","3","127576","-54","113933","-0.947368421","8.351022502382174","1"
"SLA","12/1/2018","57","13281","4","51028","-53","37747","-0.929824561","2.8421805586928697","1"
"SLA","13/1/2018","59","16381","6","111005","-53","94624","-0.898305084","5.776448324278127","1"
"SLA","14/1/2018","57","16134","0","0","-57","-16134","-1","-1","1"
"SLA","15/1/2018","62","17749","6","1906","-56","-15843","-0.903225806","-0.8926136683756831","1"
"SLA","16/1/2018","60","16962","6","1783","-54","-15179","-0.9","-0.8948826789293716","1"
"SLA","17/1/2018","62","15387","8","129297","-54","113910","-0.870967741","7.403002534607136","1"
"SLA","18/1/2018","54","13962","10","129781","-44","115819","-0.814814814","8.2953015327317","1"
"SLA","19/1/2018","59","13529","2","702","-57","-12827","-0.966101694","-0.9481114642619558","1"
"SLA","20/1/2018","59","16041","4","1510","-55","-14531","-0.932203389","-0.9058662178168443","1"
"SLA","21/1/2018","62","17703","2","581","-60","-17122","-0.967741935","-0.9671807038355081","1"
"SLA","22/1/2018","40","10885","8","1879","-32","-9006","-0.8","-0.8273771244832339","1"
"SLA","23/1/2018","52","14389","9","2339","-43","-12050","-0.826923076","-0.8374452706928904","1"
"SLA","24/1/2018","61","16040","11","2911","-50","-13129","-0.819672131","-0.8185162094763092","1"
"SLA","25/1/2018","62","14616","13","3447","-49","-11169","-0.79032258","-0.7641625615763546","1"
"SLA","26/1/2018","62","15209","21","7249","-41","-7960","-0.661290322","-0.5233743178381222","1"
"SLA","27/1/2018","43","11373","10","2951","-33","-8422","-0.76744186","-0.7405258067352501","1"
"SLA","28/1/2018","41","11189","6","1472","-35","-9717","-0.853658536","-0.8684422200375369","1"
"SLA","29/1/2018","44","11286","8","210953","-36","199667","-0.818181818","17.691564770512137","1"
"SLA","30/1/2018","45","11884","11","3256","-34","-8628","-0.755555555","-0.7260181756984181","1"
"SLA","31/1/2018","49","10476","12","92058","-37","81582","-0.75510204","7.787514318442153","1"
"SLA","1/2/2018","61","16884","3","1221","-58","-15663","-0.950819672","-0.927683013503909","1"
"SLA","2/2/2018","60","15256","4","1466","-56","-13790","-0.933333333","-0.903906659674882","1"
"SLA","3/2/2018","60","16419","11","112127","-49","95708","-0.816666666","5.829100432425848","1"
"SLA","4/2/2018","53","15226","12","103273","-41","88047","-0.773584905","5.782674372783397","1"
"SLA","5/2/2018","51","14295","13","153337","-38","139042","-0.745098039","9.726617698495978","1"
"SLA","6/2/2018","57","15607","17","4679","-40","-10928","-0.701754385","-0.7001986288204011","1"
"SLA","7/2/2018","49","11815","7","1947","-42","-9868","-0.857142857","-0.8352094794752434","1"
"SLA","8/2/2018","62","15265","5","89893","-57","74628","-0.919354838","4.888830658368818","1"
"SLA","9/2/2018","56","13706","24","8469","-32","-5237","-0.571428571","-0.3820954326572304","1"
"SLA","10/2/2018","58","16473","4","1186","-54","-15287","-0.931034482","-0.9280033995022158","1"
"SLA","11/2/2018","52","14272","6","1686","-46","-12586","-0.884615384","-0.8818665919282511","1"
"SLA","12/2/2018","49","13919","8","2071","-41","-11848","-0.836734693","-0.8512105754723759","1"
"SLA","13/2/2018","58","16493","14","239521","-44","223028","-0.758620689","13.522585339234826","1"
"SLA","14/2/2018","60","17004","13","3683","-47","-13321","-0.783333333","-0.783403904963538","1"
"SLA","15/2/2018","56","16689","17","311106","-39","294417","-0.696428571","17.641380550062916","1"
"SLA","16/2/2018","53","12384","17","113960","-36","101576","-0.679245283","8.20219638242894","1"
"SLA","17/2/2018","60","16284","19","240902","-41","224618","-0.683333333","13.793785310734464","1"
"SLA","18/2/2018","57","15515","11","3067","-46","-12448","-0.807017543","-0.8023203351595231","1"
"SLA","19/2/2018","52","13980","18","5177","-34","-8803","-0.653846153","-0.6296852646638055","1"
"SLA","20/2/2018","50","13255","16","4189","-34","-9066","-0.68","-0.6839683138438325","1"
"SLA","21/2/2018","61","15559","16","4134","-45","-11425","-0.737704918","-0.7343016903399961","1"
"SLA","22/2/2018","59","14443","19","83632","-40","69189","-0.677966101","4.79048674098179","1"
"SLA","23/2/2018","58","13951","22","7587","-36","-6364","-0.620689655","-0.4561680166296323","1"
"SLA","24/2/2018","53","13825","17","381116","-36","367291","-0.679245283","26.567160940325497","1"
"SLA","25/2/2018","46","11108","17","5231","-29","-5877","-0.630434782","-0.5290781418797263","1"
"SLA","26/2/2018","49","12397","19","190578","-30","178181","-0.612244897","14.37291280148423","1"
"SLA","27/2/2018","48","13953","23","7346","-25","-6607","-0.520833333","-0.47351823980505986","1"
"SLA","28/2/2018","59","17478","25","7883","-34","-9595","-0.576271186","-0.5489758553610253","1"
"SLA","1/3/2018","59","16455","18","94405","-41","77950","-0.694915254","4.73716195685202","1"
"SLA","2/3/2018","57","15692","25","7979","-32","-7713","-0.561403508","-0.4915243436145807","1"
"SLA","3/3/2018","56","16108","29","476847","-27","460739","-0.482142857","28.603116463868886","1"
"SLA","4/3/2018","51","13552","14","4262","-37","-9290","-0.725490196","-0.6855076741440378","1"
"SLA","5/3/2018","43","10634","16","3785","-27","-6849","-0.627906976","-0.6440662027459093","1"
"SLA","6/3/2018","48","12458","21","5506","-27","-6952","-0.5625","-0.5580349975919088","1"
"SLA","7/3/2018","52","12741","17","234196","-35","221455","-0.673076923","17.381288752845144","1"
"SLA","8/3/2018","55","12899","22","5526","-33","-7373","-0.6","-0.5715946972633538","1"
"SLA","9/3/2018","57","13014","36","448016","-21","435002","-0.368421052","33.42569540494852","1"
"SLA","10/3/2018","59","16662","27","161943","-32","145281","-0.542372881","8.71930140439323","1"
"SLA","11/3/2018","60","17131","31","163474","-29","146343","-0.483333333","8.5425836203374","1"
"SLA","12/3/2018","49","14421","20","159988","-29","145567","-0.591836734","10.094098883572567","1"
"SLA","13/3/2018","44","12471","23","7098","-21","-5373","-0.477272727","-0.4308395477507818","1"
"SLA","14/3/2018","59","15843","27","8091","-32","-7752","-0.542372881","-0.48930126869911","1"
"SLA","15/3/2018","61","16678","31","9182","-30","-7496","-0.491803278","-0.44945437102770114","1"
"SLA","16/3/2018","58","16234","24","96796","-34","80562","-0.586206896","4.962547739312554","1"
"SLA","17/3/2018","57","17409","32","861428","-25","844019","-0.438596491","48.48176230685278","1"
"SLA","18/3/2018","61","17481","25","7683","-36","-9798","-0.590163934","-0.5604942509009782","1"
"SLA","19/3/2018","62","17489","36","10085","-26","-7404","-0.419354838","-0.42335182114471953","1"
"SLA","20/3/2018","51","13468","40","11318","-11","-2150","-0.215686274","-0.15963765963765963","1"
"SLA","21/3/2018","61","16903","48","13435","-13","-3468","-0.213114754","-0.20517067976098918","1"
"SLA","22/3/2018","46","12690","38","99122","-8","86432","-0.173913043","6.811032308904649","1"
"SLA","23/3/2018","60","16709","49","410518","-11","393809","-0.183333333","23.56867556406727","1"
"SLA","24/3/2018","61","17354","43","144351","-18","126997","-0.295081967","7.318024662901925","1"
"SLA","25/3/2018","48","13855","31","140644","-17","126789","-0.354166666","9.151136773727895","1"
"SLA","26/3/2018","31","8224","21","5859","-10","-2365","-0.322580645","-0.28757295719844356","1"
"SLA","27/3/2018","32","8640","23","6714","-9","-1926","-0.28125","-0.22291666666666668","1"
"SLA","28/3/2018","45","9998","29","97459","-16","87461","-0.355555555","8.747849569913983","1"
"SLA","29/3/2018","45","12797","31","9675","-14","-3122","-0.311111111","-0.24396342892865516","1"
"SLA","30/3/2018","51","14874","32","217037","-19","202163","-0.372549019","13.59170364394245","1"
"SLA","31/3/2018","57","16468","43","14113","-14","-2355","-0.245614035","-0.14300461501093029","1"
"SLA","1/4/2018","38","11013","28","9124","-10","-1889","-0.263157894","-0.17152456188141288","1"
"SLA","2/4/2018","42","11715","34","10467","-8","-1248","-0.19047619","-0.10653008962868117","1"
"SLA","3/4/2018","55","14348","44","209730","-11","195382","-0.2","13.617368274323947","1"
"SLA","4/4/2018","58","15251","41","10445","-17","-4806","-0.293103448","-0.3151268769261032","1"
"SLA","5/4/2018","54","14482","44","12584","-10","-1898","-0.185185185","-0.1310592459605027","1"
"SLA","6/4/2018","60","16040","42","12795","-18","-3245","-0.3","-0.20230673316708228","1"
"SLA","7/4/2018","57","15724","43","220050","-14","204326","-0.245614035","12.994530653777664","1"
"SLA","8/4/2018","57","15817","46","13849","-11","-1968","-0.192982456","-0.12442308908136815","1"
"SLA","9/4/2018","57","15536","50","341448","-7","325912","-0.122807017","20.9778578784758","1"
"SLA","10/4/2018","62","17554","56","116241","-6","98687","-0.096774193","5.621909536288025","0"
"SLA","11/4/2018","60","17420","53","115856","-7","98436","-0.116666666","5.650746268656716","1"
"SLA","12/4/2018","48","12372","41","199862","-7","187490","-0.145833333","15.154380860006466","1"
"SLA","13/4/2018","49","11644","44","237651","-5","226007","-0.102040816","19.409738921332874","1"
"SLA","14/4/2018","45","12158","37","321083","-8","308925","-0.177777777","25.40919559138016","1"
"SLA","15/4/2018","25","6890","15","4844","-10","-2046","-0.4","-0.2969521044992743","1"
"SLA","16/4/2018","27","7048","22","6106","-5","-942","-0.185185185","-0.1336549375709421","1"
"SLA","17/4/2018","32","6966","26","133596","-6","126630","-0.1875","18.17829457364341","1"
"SLA","18/4/2018","56","14261","52","13402","-4","-859","-0.071428571","-0.06023420517495267","0"
"SLA","19/4/2018","50","13398","45","12271","-5","-1127","-0.1","-0.08411703239289446","1"
"SLA","20/4/2018","36","7764","33","197587","-3","189823","-0.083333333","24.44912416280268","0"
"SLA","21/4/2018","39","10712","30","519154","-9","508442","-0.23076923","47.46471247199403","1"
"SLA","22/4/2018","34","9580","28","107643","-6","98063","-0.176470588","10.236221294363256","1"
"SLA","23/4/2018","37","10994","35","392047","-2","381053","-0.054054054","34.66008732035656","0"
"SLA","24/4/2018","39","10347","34","235374","-5","225027","-0.128205128","21.748042910988694","1"
"SLA","25/4/2018","41","10828","33","343507","-8","332679","-0.195121951","30.7239564093092","1"
"SLA","26/4/2018","48","12224","35","198542","-13","186318","-0.270833333","15.241982984293193","1"
"SLA","27/4/2018","46","13228","35","414473","-11","401245","-0.239130434","30.33300574538857","1"
"SLA","28/4/2018","35","9346","30","235092","-5","225746","-0.142857142","24.154290605606676","1"
"SLA","29/4/2018","26","5496","21","5624","-5","128","-0.192307692","0.023289665211062592","1"
"SLA","30/4/2018","38","4322","34","159295","-4","154973","-0.105263157","35.85677926885701","1"
"SLA","1/5/2018","32","4696","26","3927","-6","-769","-0.1875","-0.16375638841567292","1"
"SLA","2/5/2018","26","4800","22","4605","-4","-195","-0.153846153","-0.040625","1"
"SLA","3/5/2018","20","3922","15","3443","-5","-479","-0.25","-0.12213156552779195","1"
"SLA","4/5/2018","28","6146","24","105593","-4","99447","-0.142857142","16.180767979173446","1"
"SLA","5/5/2018","37","5768","31","571851","-6","566083","-0.162162162","98.14199029126213","1"
"SLA","6/5/2018","21","4641","18","4277","-3","-364","-0.142857142","-0.0784313725490196","1"
"SLA","7/5/2018","24","4274","24","94151","0","89877","0","21.028778661675247","0"
"SLA","8/5/2018","26","5481","25","5677","-1","196","-0.038461538","0.035759897828863345","0"
"SLA","9/5/2018","49","10432","45","10247","-4","-185","-0.081632653","-0.017733895705521474","0"
"SLA","10/5/2018","49","10609","47","10955","-2","346","-0.040816326","0.0326138184560279","0"
"SLA","11/5/2018","47","9504","43","9707","-4","203","-0.085106382","0.02135942760942761","0"
"SLA","12/5/2018","21","4197","19","242108","-2","237911","-0.095238095","56.68596616630927","0"
"SLA","13/5/2018","12","2214","12","52282","0","50068","0","22.61427280939476","0"
"SLA","14/5/2018","20","5022","18","4304","-2","-718","-0.1","-0.14297092791716448","1"
"SLA","15/5/2018","21","4798","19","4702","-2","-96","-0.095238095","-0.020008336807002917","0"
"SLA","16/5/2018","25","5591","22","5209","-3","-382","-0.12","-0.06832409229118226","1"
"SLA","17/5/2018","21","4976","18","4767","-3","-209","-0.142857142","-0.0420016077170418","1"
"SLA","18/5/2018","35","7978","34","423377","-1","415399","-0.028571428","52.068062170970165","0"
"SLA","19/5/2018","34","6215","33","295634","-1","289419","-0.029411764","46.56781979082864","0"
"SLA","20/5/2018","38","7562","38","424544","0","416982","0","55.14176143877281","0"
"SLA","21/5/2018","23","4891","23","5023","0","132","0","0.02698834594152525","0"
"SLA","22/5/2018","26","5582","22","4562","-4","-1020","-0.153846153","-0.1827302042278753","1"
"SLA","23/5/2018","18","3970","18","92713","0","88743","0","22.35340050377834","0"
"SLA","24/5/2018","23","4727","23","5249","0","522","0","0.11042944785276074","0"
"SLA","25/5/2018","29","6655","29","251201","0","244546","0","36.746205860255444","0"
"SLA","26/5/2018","36","8390","34","8659","-2","269","-0.055555555","0.032061978545887965","0"
"SLA","27/5/2018","17","5585","16","3993","-1","-1592","-0.058823529","-0.28504923903312446","0"
"SLA","28/5/2018","12","2169","12","2535","0","366","0","0.16874135546334718","0"
"SLA","29/5/2018","15","3532","13","3252","-2","-280","-0.133333333","-0.07927519818799547","1"
"SLA","30/5/2018","24","4151","22","5199","-2","1048","-0.083333333","0.2524692845097567","0"
"SLA","31/5/2018","29","7096","27","6521","-2","-575","-0.068965517","-0.0810315670800451","0"
"SLA","1/6/2018","34","7054","34","107810","0","100756","0","14.283527076835838","0"
"SLA","2/6/2018","31","6780","31","112203","0","105423","0","15.549115044247788","0"
"SLA","3/6/2018","26","4514","25","5317","-1","803","-0.038461538","0.17789100575985822","0"
"SLA","4/6/2018","20","3852","19","3813","-1","-39","-0.05","-0.010124610591900311","0"
"SLA","5/6/2018","21","4407","20","4282","-1","-125","-0.047619047","-0.028363966417063763","0"
"SLA","6/6/2018","15","3231","14","2870","-1","-361","-0.066666666","-0.11173011451562984","0"
"SLA","7/6/2018","24","4616","22","4537","-2","-79","-0.083333333","-0.017114384748700175","0"
"SLA","8/6/2018","25","3619","22","158520","-3","154901","-0.12","42.802155291516996","1"
"SLA","9/6/2018","21","4055","19","223722","-2","219667","-0.095238095","54.171886559802715","0"
"SLA","10/6/2018","20","3150","19","3666","-1","516","-0.05","0.16380952380952382","0"
"SLA","11/6/2018","33","6195","33","6880","0","685","0","0.11057304277643261","0"
"SLA","12/6/2018","31","5814","31","6429","0","615","0","0.10577915376676987","0"
"SLA","13/6/2018","20","3785","20","4150","0","365","0","0.0964332892998679","0"
"SLA","14/6/2018","27","5599","27","95074","0","89475","0","15.980532237899626","0"
"SLA","15/6/2018","33","6876","33","373823","0","366947","0","53.36634671320535","0"
"SLA","16/6/2018","35","6907","35","107855","0","100948","0","14.615317793542783","0"
"SLA","17/6/2018","15","2785","12","2510","-3","-275","-0.2","-0.09874326750448834","1"
"SLA","18/6/2018","16","3124","13","2785","-3","-339","-0.1875","-0.10851472471190782","1"
"SLA","19/6/2018","21","4310","20","4435","-1","125","-0.047619047","0.029002320185614848","0"
"SLA","20/6/2018","34","6106","28","94242","-6","88136","-0.176470588","14.434326891582051","1"
"SLA","21/6/2018","31","7174","25","5860","-6","-1314","-0.193548387","-0.1831614162252579","1"
"SLA","22/6/2018","41","8128","38","602771","-3","594643","-0.073170731","73.15981791338582","0"
"SLA","23/6/2018","25","5972","23","5863","-2","-109","-0.08","-0.01825184192900201","0"
"SLA","24/6/2018","18","3445","17","3928","-1","483","-0.055555555","0.14020319303338172","0"
"SLA","25/6/2018","18","3884","18","4202","0","318","0","0.08187435633367662","0"
"SLA","26/6/2018","19","3914","15","3136","-4","-778","-0.210526315","-0.198773633111906","1"
"SLA","27/6/2018","16","3324","15","3243","-1","-81","-0.0625","-0.024368231046931407","0"
"SLA","28/6/2018","16","3227","13","2975","-3","-252","-0.1875","-0.07809110629067245","1"
"SLA","29/6/2018","17","2839","15","2895","-2","56","-0.117647058","0.019725255371609723","1"
"SLA","30/6/2018","25","4870","23","5530","-2","660","-0.08","0.13552361396303902","0"
"SLA","1/7/2018","22","4611","22","5431","0","820","0","0.17783561049663849","0"
"SLA","2/7/2018","27","5691","27","6597","0","906","0","0.1591987348444913","0"
"SLA","3/7/2018","29","5862","28","95540","-1","89678","-0.034482758","15.298191743432275","0"
"SLA","4/7/2018","27","5278","26","5202","-1","-76","-0.037037037","-0.014399393709738537","0"
"SLA","5/7/2018","29","6061","29","6472","0","411","0","0.06781059231149976","0"
"SLA","6/7/2018","33","7009","33","288000","0","280991","0","40.090027108003994","0"
"SLA","7/7/2018","37","7267","36","7963","-1","696","-0.027027027","0.09577542314572726","0"
"SLA","8/7/2018","30","5693","30","6310","0","617","0","0.10837871069734761","0"
"SLA","9/7/2018","36","6648","36","7329","0","681","0","0.10243682310469314","0"
"SLA","10/7/2018","26","3311","26","5272","0","1961","0","0.5922681969193597","0"
"SLA","11/7/2018","31","5321","28","5492","-3","171","-0.096774193","0.03213681638789701","0"
"SLA","12/7/2018","29","5699","26","5773","-3","74","-0.103448275","0.0129847341638884","1"
"SLA","13/7/2018","26","5517","24","5822","-2","305","-0.076923076","0.055283668660503896","0"
"SLA","14/7/2018","36","7493","33","8015","-3","522","-0.083333333","0.06966502068597358","0"
"SLA","15/7/2018","35","7279","32","7746","-3","467","-0.085714285","0.06415716444566562","0"
"SLA","16/7/2018","28","5389","25","5792","-3","403","-0.107142857","0.07478196325848951","1"
"SLA","17/7/2018","27","5251","26","5776","-1","525","-0.037037037","0.09998095600837936","0"
"SLA","18/7/2018","22","4634","20","204501","-2","199867","-0.09090909","43.13055675442382","0"
"SLA","19/7/2018","23","4214","21","159703","-2","155489","-0.086956521","36.898196487897486","0"
"SLA","20/7/2018","38","8332","31","7715","-7","-617","-0.184210526","-0.07405184829572732","1"
"SLA","21/7/2018","37","8016","31","7588","-6","-428","-0.162162162","-0.053393213572854294","1"
"SLA","22/7/2018","32","6496","32","7231","0","735","0","0.11314655172413793","0"
"SLA","23/7/2018","31","6105","31","6844","0","739","0","0.12104832104832104","0"
"SLA","24/7/2018","35","6284","35","7337","0","1053","0","0.16756842775302355","0"
"SLA","25/7/2018","43","8475","43","84883","0","76408","0","9.015693215339233","0"
"SLA","26/7/2018","43","8036","41","8706","-2","670","-0.046511627","0.08337481333997014","0"
"SLA","27/7/2018","41","7816","41","283619","0","275803","0","35.28697543500512","0"
"SLA","28/7/2018","34","7123","33","162513","-1","155390","-0.029411764","21.81524638495016","0"
"SLA","29/7/2018","18","3937","17","4139","-1","202","-0.055555555","0.051308102616205234","0"
"SLA","30/7/2018","28","6408","25","6353","-3","-55","-0.107142857","-0.008583021223470662","1"
"SLA","31/7/2018","31","7065","27","7007","-4","-58","-0.129032258","-0.008209483368719038","1"
"SLA","1/8/2018","40","8143","40","836002","0","827859","0","101.66511113840109","0"
"SLA","2/8/2018","27","5966","27","6734","0","768","0","0.1287294669795508","0"
"SLA","3/8/2018","28","6213","28","6896","0","683","0","0.10993079027844842","0"
"SLA","4/8/2018","23","5187","23","5180","0","-7","0","-0.001349527665317139","0"
"SLA","5/8/2018","15","3137","14","3257","-1","120","-0.066666666","0.03825310806503028","0"
"SLA","6/8/2018","23","3491","23","157531","0","154040","0","44.12489258092237","0"
"SLA","7/8/2018","32","3173","30","235089","-2","231916","-0.0625","73.09045067759219","0"
"SLA","8/8/2018","38","6945","38","395005","0","388060","0","55.87616990640749","0"
"SLA","9/8/2018","37","7664","37","242737","0","235073","0","30.672364300626306","0"
"SLA","10/8/2018","30","5580","25","105577","-5","99997","-0.166666666","17.920609318996416","1"
"SLA","11/8/2018","32","6175","29","161348","-3","155173","-0.09375","25.12923076923077","0"
"SLA","12/8/2018","19","3769","19","197637","0","193868","0","51.437516582647916","0"
"SLA","13/8/2018","21","4653","21","5058","0","405","0","0.08704061895551257","0"
"SLA","14/8/2018","26","5901","26","156269","0","150368","0","25.481782748686662","0"
"SLA","15/8/2018","28","5845","28","135159","0","129314","0","22.12386655260907","0"
"SLA","16/8/2018","33","7062","33","136612","0","129550","0","18.344661568960635","0"
"SLA","17/8/2018","41","8201","41","265055","0","256854","0","31.319839044019023","0"
"SLA","18/8/2018","43","8272","43","236519","0","228247","0","27.59272243713733","0"
"SLA","19/8/2018","43","8822","43","10025","0","1203","0","0.13636363636363635","0"
"SLA","20/8/2018","34","6659","34","7500","0","841","0","0.12629523952545427","0"
"SLA","21/8/2018","53","10373","53","11891","0","1518","0","0.14634146341463414","0"
"SLA","22/8/2018","49","9506","49","10399","0","893","0","0.09394066905112561","0"
"SLA","23/8/2018","53","10191","53","11037","0","846","0","0.083014424492199","0"
"SLA","24/8/2018","52","9214","52","10686","0","1472","0","0.15975689168656393","0"
"SLA","25/8/2018","43","9074","38","143508","-5","134434","-0.116279069","14.815296451399604","1"
"SLA","26/8/2018","40","8070","40","9274","0","1204","0","0.14919454770755886","0"
"SLA","27/8/2018","36","6371","36","8699","0","2328","0","0.3654057447810391","0"
"SLA","28/8/2018","35","7792","35","8550","0","758","0","0.09727926078028748","0"
"SLA","29/8/2018","32","6524","32","7224","0","700","0","0.1072961373390558","0"
"SLA","30/8/2018","33","6049","33","83380","0","77331","0","12.784096544883452","0"
"SLA","31/8/2018","34","7010","34","151474","0","144464","0","20.60827389443652","0"
"SLA","1/9/2018","41","7672","40","8453","-1","781","-0.024390243","0.10179874869655892","0"
"SLA","2/9/2018","25","4525","25","104293","0","99768","0","22.048176795580112","0"
"SLA","3/9/2018","33","5875","32","6407","-1","532","-0.03030303","0.09055319148936171","0"
"SLA","4/9/2018","37","6990","36","7746","-1","756","-0.027027027","0.10815450643776824","0"
"SLA","5/9/2018","50","9521","49","86749","-1","77228","-0.02","8.111332843188741","0"
"SLA","6/9/2018","50","9877","48","10392","-2","515","-0.04","0.052141338463096085","0"
"SLA","7/9/2018","45","9075","44","209504","-1","200429","-0.022222222","22.085840220385673","0"
"SLA","8/9/2018","48","10404","48","111249","0","100845","0","9.692906574394463","0"
"SLA","9/9/2018","40","7738","40","9135","0","1397","0","0.18053760661669682","0"
"SLA","10/9/2018","33","6150","33","7253","0","1103","0","0.17934959349593496","0"
"SLA","11/9/2018","42","8484","41","161959","-1","153475","-0.023809523","18.089933993399338","0"
"SLA","12/9/2018","22","4609","21","5001","-1","392","-0.045454545","0.08505098719895855","0"
"SLA","13/9/2018","16","3552","16","3929","0","377","0","0.10613738738738739","0"
"SLA","14/9/2018","18","3593","17","4109","-1","516","-0.055555555","0.14361258001669913","0"
"SLA","15/9/2018","24","5517","22","5761","-2","244","-0.083333333","0.04422693492840312","0"
"SLA","16/9/2018","20","3958","17","197124","-3","193166","-0.15","48.803941384537644","1"
"SLA","17/9/2018","18","3272","16","158319","-2","155047","-0.111111111","47.386002444987774","1"
"SLA","18/9/2018","40","7530","37","7715","-3","185","-0.075","0.024568393094289508","0"
"SLA","19/9/2018","36","6983","33","7148","-3","165","-0.083333333","0.023628812831161392","0"
"SLA","20/9/2018","23","4640","21","198425","-2","193785","-0.086956521","41.76400862068966","0"
"SLA","21/9/2018","21","4275","21","109987","0","105712","0","24.727953216374267","0"
"SLA","22/9/2018","29","5798","29","69863","0","64065","0","11.049499827526734","0"
"SLA","23/9/2018","28","6015","28","6625","0","610","0","0.10141313383208644","0"
"SLA","24/9/2018","52","10576","52","107367","0","96791","0","9.15194780635401","0"
"SLA","25/9/2018","54","9668","54","105827","0","96159","0","9.946110881257757","0"
"SLA","26/9/2018","61","9691","61","164407","0","154716","0","15.96491590135177","0"
"SLA","27/9/2018","39","7632","39","197758","0","190126","0","24.911687631027252","0"
"SLA","28/9/2018","28","6174","28","380228","0","374054","0","60.58535795270489","0"
"SLA","29/9/2018","32","7399","32","931950","0","924551","0","124.95621029868902","0"
"SLA","30/9/2018","33","8051","31","7949","-2","-102","-0.06060606","-0.012669233635573221","0"
"SLA","1/10/2018","36","7814","33","7698","-3","-116","-0.083333333","-0.0148451497312516","0"
"SLA","2/10/2018","23","5488","21","235123","-2","229635","-0.086956521","41.84311224489796","0"
"SLA","3/10/2018","23","5462","23","95082","0","89620","0","16.40790919077261","0"
"SLA","4/10/2018","31","7301","26","7052","-5","-249","-0.161290322","-0.03410491713463909","1"
"SLA","5/10/2018","40","8368","39","275161","-1","266793","-0.025","31.882528680688335","0"
"SLA","6/10/2018","37","9904","36","308284","-1","298380","-0.027027027","30.127221324717286","0"
"SLA","7/10/2018","37","8905","37","10202","0","1297","0","0.14564851207186974","0"
"SLA","8/10/2018","47","8094","47","179385","0","171291","0","21.162713120830244","0"
"SLA","9/10/2018","55","11450","54","352765","-1","341315","-0.018181818","29.809170305676854","0"
"SLA","10/10/2018","49","11046","48","525669","-1","514623","-0.020408163","46.58908202064096","0"
"SLA","11/10/2018","56","13327","55","438966","-1","425639","-0.017857142","31.93809559540782","0"
"SLA","12/10/2018","56","11987","51","351948","-5","339961","-0.089285714","28.360807541503295","0"
"SLA","13/10/2018","35","6538","30","360610","-5","354072","-0.142857142","54.15601101254206","1"
"SLA","14/10/2018","26","6180","24","6448","-2","268","-0.076923076","0.04336569579288026","0"
"SLA","15/10/2018","31","9149","31","9935","0","786","0","0.08591102852770795","0"
"SLA","16/10/2018","44","11486","44","12827","0","1341","0","0.11675082709385338","0"
"SLA","17/10/2018","38","11091","37","12056","-1","965","-0.026315789","0.08700748354521684","0"
"SLA","18/10/2018","41","11073","40","100908","-1","89835","-0.024390243","8.112977512869142","0"
"SLA","19/10/2018","45","10923","43","10848","-2","-75","-0.044444444","-0.006866245536940401","0"
"SLA","20/10/2018","61","15221","59","116412","-2","101191","-0.032786885","6.648117732080678","0"
"SLA","21/10/2018","52","13586","50","113853","-2","100267","-0.038461538","7.380170764021787","0"
"SLA","22/10/2018","43","10278","42","11304","-1","1026","-0.023255813","0.09982486865148861","0"
"SLA","23/10/2018","53","12803","52","211826","-1","199023","-0.018867924","15.545028508943217","0"
"SLA","24/10/2018","61","15130","60","147876","-1","132746","-0.016393442","8.773694646397885","0"
"SLA","25/10/2018","36","10047","35","140932","-1","130885","-0.027777777","13.027271822434557","0"
"SLA","26/10/2018","51","12916","43","320331","-8","307415","-0.156862745","23.801099411582534","1"
"SLA","27/10/2018","52","14170","49","208411","-3","194241","-0.057692307","13.707904022582921","0"
"SLA","28/10/2018","37","10333","32","8890","-5","-1443","-0.135135135","-0.13964966611826188","1"
"SLA","29/10/2018","34","6617","33","6781","-1","164","-0.029411764","0.024784645609792957","0"
"SLA","30/10/2018","55","12056","53","12351","-2","295","-0.036363636","0.02446914399469144","0"
"SLA","31/10/2018","61","15455","54","14710","-7","-745","-0.114754098","-0.04820446457457134","1"
"SLA","1/11/2018","61","15602","57","16628","-4","1026","-0.06557377","0.06576079989744904","0"
"SLA","2/11/2018","60","15051","55","18193","-5","3142","-0.083333333","0.20875689322968574","0"
"SLA","3/11/2018","47","13871","44","14212","-3","341","-0.063829787","0.02458366375892149","0"
"SLA","4/11/2018","42","10894","39","11248","-3","354","-0.071428571","0.03249495134936663","0"
"SLA","5/11/2018","34","9276","32","9423","-2","147","-0.058823529","0.015847347994825355","0"
"SLA","6/11/2018","53","14163","50","208248","-3","194085","-0.056603773","13.703664477864859","0"
"SLA","7/11/2018","50","13330","49","102825","-1","89495","-0.02","6.713803450862716","0"
"SLA","8/11/2018","59","17511","57","17042","-2","-469","-0.033898305","-0.026783164867797384","0"
"SLA","9/11/2018","54","14182","53","15252","-1","1070","-0.018518518","0.0754477506698632","0"
"SLA","10/11/2018","50","14810","48","15377","-2","567","-0.04","0.038284942606347065","0"
"SLA","11/11/2018","46","13319","44","14040","-2","721","-0.04347826","0.054133193182671374","0"
"SLA","12/11/2018","46","13141","43","13399","-3","258","-0.065217391","0.019633209040407884","0"
"SLA","13/11/2018","59","16795","53","197523","-6","180728","-0.101694915","10.760821673116999","1"
"SLA","14/11/2018","62","17429","56","67551","-6","50122","-0.096774193","2.8757817430718915","0"
"SLA","15/11/2018","61","16824","53","16278","-8","-546","-0.13114754","-0.03245363766048502","1"
"SLA","16/11/2018","60","14445","58","18833","-2","4388","-0.033333333","0.303772931810315","0"
"SLA","17/11/2018","62","17214","61","18624","-1","1410","-0.016129032","0.08191007319623562","0"
"SLA","18/11/2018","58","15937","56","16874","-2","937","-0.034482758","0.058794001380435466","0"
"SLA","19/11/2018","49","11702","48","132581","-1","120879","-0.020408163","10.329772688429328","0"
"SLA","20/11/2018","49","12835","49","132951","0","120116","0","9.358472925594079","0"
"SLA","21/11/2018","33","8672","33","99102","0","90430","0","10.427813653136532","0"
"SLA","22/11/2018","33","8781","32","10115","-1","1334","-0.03030303","0.15191891584102038","0"
"SLA","23/11/2018","62","17932","54","17132","-8","-800","-0.129032258","-0.04461298237787196","1"
"SLA","24/11/2018","61","17517","51","15621","-10","-1896","-0.163934426","-0.10823771193697551","1"
"SLA","25/11/2018","42","11028","40","12162","-2","1134","-0.047619047","0.10282916213275299","0"
"SLA","26/11/2018","45","13583","43","14173","-2","590","-0.044444444","0.04343664875211661","0"
"SLA","27/11/2018","61","18595","61","19211","0","616","0","0.03312718472707717","0"
"SLA","28/11/2018","53","16009","53","122300","0","106291","0","6.639452807795615","0"
"SLA","29/11/2018","61","17899","60","427662","-1","409763","-0.016393442","22.893066651768255","0"
"SLA","30/11/2018","52","15395","52","391058","0","375663","0","24.40162390386489","0"
"SLA","1/12/2018","49","14293","49","576559","0","562266","0","39.338557335758765","0"
"SLA","2/12/2018","43","13658","43","14996","0","1338","0","0.09796456289354225","0"
"SLA","3/12/2018","37","11289","37","12183","0","894","0","0.07919213393568961","0"
"SLA","4/12/2018","40","11392","36","164813","-4","153421","-0.1","13.467433286516854","1"
"SLA","5/12/2018","36","9989","32","109502","-4","99513","-0.111111111","9.962258484332766","1"
"SLA","6/12/2018","44","13271","43","223575","-1","210304","-0.022727272","15.846884183558135","0"
"SLA","7/12/2018","50","14750","50","116119","0","101369","0","6.872474576271187","0"
"SLA","8/12/2018","47","14813","46","366865","-1","352052","-0.021276595","23.76642138661986","0"
"SLA","9/12/2018","55","16647","54","18023","-1","1376","-0.018181818","0.08265753589235297","0"
"SLA","10/12/2018","49","14866","49","15951","0","1085","0","0.07298533566527647","0"
"SLA","11/12/2018","45","12286","45","13329","0","1043","0","0.08489337457268435","0"
"SLA","12/12/2018","38","9726","37","10200","-1","474","-0.026315789","0.048735348550277606","0"
"SLA","13/12/2018","56","16564","54","300347","-2","283783","-0.035714285","17.13251630041053","0"
"SLA","14/12/2018","54","16748","54","306573","0","289825","0","17.305051349414857","0"
"SLA","15/12/2018","61","18169","61","462647","0","444478","0","24.463536793439374","0"
"SLA","16/12/2018","58","17283","58","18729","0","1446","0","0.08366603020308974","0"
"SLA","17/12/2018","45","13872","43","13678","-2","-194","-0.044444444","-0.013985005767012688","0"
"SLA","18/12/2018","37","9824","37","11174","0","1350","0","0.1374185667752443","0"
"SLA","19/12/2018","48","14023","48","15160","0","1137","0","0.08108108108108109","0"
"SLA","20/12/2018","51","14077","50","15331","-1","1254","-0.019607843","0.08908148042906869","0"
"SLA","21/12/2018","62","16222","60","19970","-2","3748","-0.032258064","0.23104426088028604","0"
"SLA","22/12/2018","62","18191","52","505700","-10","487509","-0.161290322","26.79946127205761","1"
"SLA","23/12/2018","57","17384","54","17740","-3","356","-0.052631578","0.02047860101242522","0"
"SLA","24/12/2018","46","14061","46","15846","0","1785","0","0.1269468743332622","0"
"SLA","25/12/2018","47","14867","46","15725","-1","858","-0.021276595","0.057711710499764576","0"
"SLA","26/12/2018","62","19917","58","19325","-4","-592","-0.064516129","-0.029723351910428276","0"
"SLA","27/12/2018","55","15725","49","16148","-6","423","-0.109090909","0.026899841017488078","1"
"SLA","28/12/2018","59","18052","57","19275","-2","1223","-0.033898305","0.06774872590294705","0"
"SLA","29/12/2018","56","17671","55","18951","-1","1280","-0.017857142","0.07243506309773075","0"
"SLA","30/12/2018","57","18163","52","17691","-5","-472","-0.087719298","-0.025986896437813135","0"
"SLA","31/12/2018","57","17334","57","19103","0","1769","0","0.10205376716280143","0"
"SLA","1/1/2019","50","16922","50","17005","0","83","0","0.004904857581846118","0"
"SLA","2/1/2019","62","19778","62","20653","0","875","0","0.04424107594296693","0"
"SLA","3/1/2019","60","19364","59","19453","-1","89","-0.016666666","0.004596157818632514","0"
"SLA","4/1/2019","62","20069","59","19322","-3","-747","-0.048387096","-0.03722158552992177","0"
"SLA","5/1/2019","61","16896","59","17650","-2","754","-0.032786885","0.04462594696969697","0"
"SLA","6/1/2019","61","19743","60","20629","-1","886","-0.016393442","0.04487666514714076","0"
"SLA","7/1/2019","43","13404","43","13780","0","376","0","0.028051327961802448","0"
"SLA","8/1/2019","52","14593","52","114388","0","99795","0","6.838552730761324","0"
"SLA","9/1/2019","61","16295","61","17644","0","1349","0","0.08278613071494323","0"
"SLA","10/1/2019","62","17172","62","18531","0","1359","0","0.07914046121593292","0"
"SLA","11/1/2019","61","16131","61","20231","0","4100","0","0.25416899138305127","0"
"SLA","12/1/2019","59","17723","59","19372","0","1649","0","0.0930429385544208","0"
"SLA","13/1/2019","42","13093","42","13900","0","807","0","0.06163598869624991","0"
"SLA","14/1/2019","37","11395","36","11759","-1","364","-0.027027027","0.031943835015357615","0"
"SLA","15/1/2019","44","12790","42","118698","-2","105908","-0.045454545","8.280531665363565","0"
"SLA","16/1/2019","52","15209","51","121824","-1","106615","-0.019230769","7.00999408245118","0"
"SLA","17/1/2019","58","17087","58","243882","0","226795","0","13.272956048457893","0"
"SLA","18/1/2019","59","17822","59","245050","0","227228","0","12.749859723936707","0"
"SLA","19/1/2019","58","16874","57","243974","-1","227100","-0.017241379","13.458575322982103","0"
"SLA","20/1/2019","61","17675","60","137978","-1","120303","-0.016393442","6.806393210749646","0"
"SLA","21/1/2019","46","11999","46","132808","0","120809","0","10.068255687973998","0"
"SLA","22/1/2019","49","13570","49","1149984","0","1136414","0","83.7445836403832","0"
"SLA","23/1/2019","54","15169","54","449770","0","434601","0","28.650603203902698","0"
"SLA","24/1/2019","60","16290","59","17237","-1","947","-0.016666666","0.058133824432166976","0"
"SLA","25/1/2019","62","16567","60","20651","-2","4084","-0.032258064","0.24651415464477575","0"
"SLA","26/1/2019","54","16418","52","17128","-2","710","-0.037037037","0.04324521866244366","0"
"SLA","27/1/2019","39","11345","38","11837","-1","492","-0.025641025","0.04336712208021155","0"
"SLA","28/1/2019","41","12462","40","13513","-1","1051","-0.024390243","0.08433638260311346","0"
"SLA","29/1/2019","41","12836","39","13143","-2","307","-0.048780487","0.023917108133374883","0"
"SLA","30/1/2019","48","13255","45","14578","-3","1323","-0.0625","0.0998113919275745","0"
"SLA","31/1/2019","55","15656","54","16739","-1","1083","-0.018181818","0.0691747572815534","0"
"SLA","1/2/2019","62","15116","62","19782","0","4666","0","0.30867954485313576","0"
"SLA","2/2/2019","52","14190","51","15183","-1","993","-0.019230769","0.06997885835095137","0"
"SLA","3/2/2019","45","12872","44","132235","-1","119363","-0.022222222","9.273073337476694","0"
"SLA","4/2/2019","60","15070","59","135021","-1","119951","-0.016666666","7.959588586595886","0"
"SLA","5/2/2019","53","15312","50","15324","-3","12","-0.056603773","0.0007836990595611285","0"
"SLA","6/2/2019","51","14963","52","16422","1","1459","0.019607843","0.09750718438815746","0"
"SLA","7/2/2019","62","16609","63","18339","1","1730","0.016129032","0.10416039496658439","0"
"SLA","8/2/2019","52","14840","55","19215","3","4375","0.057692307","0.294811320754717","0"
"SLA","9/2/2019","38","11679","38","12434","0","755","0","0.06464594571453035","0"
"SLA","10/2/2019","47","15196","48","14586","1","-610","0.021276595","-0.04014214266912346","0"
"SLA","11/2/2019","40","11628","42","12295","2","667","0.05","0.05736154110767114","0"
"SLA","12/2/2019","52","15542","55","17130","3","1588","0.057692307","0.10217475228413332","0"
"SLA","13/2/2019","56","15314","57","66661","1","51347","0.017857142","3.352945017630926","0"
"SLA","14/2/2019","62","17879","65","19548","3","1669","0.048387096","0.09334973991833995","0"
"SLA","15/2/2019","57","16574","60","107376","3","90802","0.052631578","5.478580909858815","0"
"SLA","16/2/2019","57","17590","60","19888","3","2298","0.052631578","0.1306424104604889","0"
"SLA","17/2/2019","45","14168","45","15307","0","1139","0","0.08039243365330322","0"
"SLA","18/2/2019","44","12498","49","14252","5","1754","0.113636363","0.14034245479276683","1"
"SLA","19/2/2019","48","10873","57","17203","9","6330","0.1875","0.5821760323737699","1"
"SLA","20/2/2019","57","16474","62","19125","5","2651","0.087719298","0.1609202379507102","0"
"SLA","21/2/2019","57","15383","62","18494","5","3111","0.087719298","0.2022362348046545","0"
"SLA","22/2/2019","45","11524","47","104813","2","93289","0.044444444","8.095192641443942","0"
"SLA","23/2/2019","60","18103","62","19898","2","1795","0.033333333","0.09915483621499199","0"
"SLA","24/2/2019","48","14348","50","15688","2","1340","0.041666666","0.09339280735991079","0"
"SLA","25/2/2019","34","9457","36","9734","2","277","0.058823529","0.029290472665750238","0"
"SLA","26/2/2019","39","10912","39","10762","0","-150","0","-0.01374633431085044","0"
"SLA","27/2/2019","49","13426","56","14718","7","1292","0.142857142","0.0962311932072099","1"
"SLA","28/2/2019","40","11948","45","12505","5","557","0.125","0.046618680950786744","1"
"SLA","1/3/2019","57","16632","58","173510","1","156878","0.017543859","9.432299182299182","0"
"SLA","2/3/2019","61","17405","63","214019","2","196614","0.032786885","11.296409077851193","0"
"SLA","3/3/2019","55","14601","58","16954","3","2353","0.054545454","0.16115334566125608","0"
"SLA","4/3/2019","42","10810","46","12781","4","1971","0.095238095","0.18233117483811287","0"
"SLA","5/3/2019","51","13489","56","126880","5","113391","0.098039215","8.406182815627549","0"
"SLA","6/3/2019","54","14096","57","16719","3","2623","0.055555555","0.18608115777525538","0"
"SLA","7/3/2019","45","12100","45","101363","0","89263","0","7.377107438016529","0"
"SLA","8/3/2019","62","17607","65","21694","3","4087","0.048387096","0.23212358720963253","0"
"SLA","9/3/2019","56","16313","62","286552","6","270239","0.107142857","16.56586771286704","1"
"SLA","10/3/2019","49","14603","51","16313","2","1710","0.040816326","0.11709922618640005","0"
"SLA","11/3/2019","48","14283","51","16049","3","1766","0.0625","0.12364349226353007","0"
"SLA","12/3/2019","43","13641","45","13972","2","331","0.046511627","0.024265083205043617","0"
"SLA","13/3/2019","46","13050","50","15650","4","2600","0.086956521","0.19923371647509577","0"
"SLA","14/3/2019","44","11582","43","101363","-1","89781","-0.022727272","7.751769987912278","0"
"SLA","15/3/2019","59","16886","59","137450","0","120564","0","7.139879189861424","0"
"SLA","16/3/2019","55","16491","59","417347","4","400856","0.072727272","24.307561700321386","0"
"SLA","17/3/2019","54","15975","56","137784","2","121809","0.037037037","7.624976525821596","0"
"SLA","18/3/2019","34","9799","36","219990","2","210191","0.058823529","21.45025002551281","0"
"SLA","19/3/2019","31","9279","31","9849","0","570","0","0.061429033301002266","0"
"SLA","20/3/2019","62","17891","60","17904","-2","13","-0.032258064","0.0007266223240735565","0"
"SLA","21/3/2019","62","17502","63","18079","1","577","0.016129032","0.032967660838761285","0"
"SLA","22/3/2019","40","12615","45","103317","5","90702","0.125","7.190011890606421","1"
"SLA","23/3/2019","44","13149","47","171355","3","158206","0.068181818","12.031789489695035","0"
"SLA","24/3/2019","29","8175","30","7823","1","-352","0.034482758","-0.04305810397553517","0"
"SLA","25/3/2019","24","7149","24","7246","0","97","0","0.013568331235137782","0"
"SLA","26/3/2019","40","11470","40","11951","0","481","0","0.041935483870967745","0"
"SLA","27/3/2019","41","11141","41","118040","0","106899","0","9.595099183197199","0"
"SLA","28/3/2019","50","15023","51","121981","1","106958","0.02","7.119616587898555","0"
"SLA","29/3/2019","39","11255","42","532342","3","521087","0.076923076","46.2982674366948","0"
"SLA","30/3/2019","31","8820","32","642682","1","633862","0.032258064","71.86643990929706","0"
"SLA","31/3/2019","20","5051","20","5872","0","821","0","0.16254207087705405","0"
"SLA","1/4/2019","39","7926","42","9588","3","1662","0.076923076","0.20968962906888722","0"
"SLA","2/4/2019","40","9803","46","163691","6","153888","0.15","15.698051616851984","1"
"SLA","3/4/2019","44","10189","46","1968283","2","1958094","0.045454545","192.17724997546372","0"
"SLA","4/4/2019","45","11251","46","1879875","1","1868624","0.022222222","166.0851479868456","0"
"SLA","5/4/2019","40","11431","41","173085","1","161654","0.025","14.141719884524539","0"
"SLA","6/4/2019","50","13418","52","574094","2","560676","0.04","41.785362945297365","0"
"SLA","7/4/2019","54","13362","56","267581","2","254219","0.037037037","19.02552013171681","0"
"SLA","8/4/2019","41","9801","42","309520","1","299719","0.024390243","30.58045097439037","0"
"SLA","9/4/2019","35","8806","33","232099","-2","223293","-0.057142857","25.35691573926868","0"
"SLA","10/4/2019","42","12056","41","12463","-1","407","-0.023809523","0.03375912408759124","0"
"SLA","11/4/2019","48","12370","48","536618","0","524248","0","42.38059822150364","0"
"SLA","12/4/2019","45","11990","47","682038","2","670048","0.044444444","55.883903252710596","0"
"SLA","13/4/2019","57","15523","58","1390811","1","1375288","0.017543859","88.59679185724409","0"
"SLA","14/4/2019","30","8070","31","8717","1","647","0.033333333","0.0801734820322181","0"
"SLA","15/4/2019","27","7439","28","8516","1","1077","0.037037037","0.14477752386073398","0"
"SLA","16/4/2019","24","6329","24","6832","0","503","0","0.07947543055775004","0"
"SLA","17/4/2019","26","6825","26","7353","0","528","0","0.07736263736263736","0"
"SLA","18/4/2019","26","6175","26","310730","0","304555","0","49.320647773279354","0"
"SLA","19/4/2019","28","6174","29","7448","1","1274","0.035714285","0.20634920634920634","0"
"SLA","20/4/2019","48","13135","49","450505","1","437370","0.020833333","33.29805862200229","0"
"SLA","21/4/2019","57","13424","57","967015","0","953591","0","71.03627830750894","0"
"SLA","22/4/2019","41","9077","41","962691","0","953614","0","105.0582791671257","0"
"SLA","23/4/2019","36","8037","36","643319","0","635282","0","79.04466840861018","0"
"SLA","24/4/2019","21","4728","21","320366","0","315638","0","66.7593062605753","0"
"SLA","25/4/2019","35","7578","35","8734","0","1156","0","0.15254684613354447","0"
"SLA","26/4/2019","44","10011","44","313786","0","303775","0","30.344121466386973","0"
"SLA","27/4/2019","47","8896","48","371252","1","362356","0.021276595","40.73246402877698","0"
"SLA","28/4/2019","32","6766","32","7336","0","570","0","0.08424475317765297","0"
"SLA","29/4/2019","22","4932","24","5990","2","1058","0.09090909","0.21451743714517438","0"
"SLA","30/4/2019","34","7074","34","7799","0","725","0","0.10248798416737348","0"
"SLA","1/5/2019","26","4391","26","4980","0","589","0","0.13413800956501937","0"
"SLA","2/5/2019","29","5100","29","5912","0","812","0","0.1592156862745098","0"
"SLA","3/5/2019","33","6698","33","153445","0","146747","0","21.909077336518365","0"
"SLA","4/5/2019","60","12626","62","227941","2","215315","0.033333333","17.05330270869634","0"
"SLA","5/5/2019","58","12320","59","13929","1","1609","0.017241379","0.13060064935064936","0"
"SLA","6/5/2019","62","12083","64","13432","2","1349","0.032258064","0.111644459157494","0"
"SLA","7/5/2019","62","12028","64","13748","2","1720","0.032258064","0.14299966744263384","0"
"SLA","8/5/2019","52","10725","52","11420","0","695","0","0.0648018648018648","0"
"SLA","9/5/2019","55","10984","56","12475","1","1491","0.018181818","0.1357428987618354","0"
"SLA","10/5/2019","45","9363","44","228940","-1","219577","-0.022222222","23.451564669443556","0"
"SLA","11/5/2019","38","7692","38","8482","0","790","0","0.10270410816432657","0"
"SLA","12/5/2019","17","3747","17","3643","0","-104","0","-0.02775553776354417","0"
"SLA","13/5/2019","31","4505","31","6173","0","1668","0","0.3702552719200888","0"
"SLA","14/5/2019","30","6591","30","6280","0","-311","0","-0.04718555606129571","0"
"SLA","15/5/2019","25","4362","25","4882","0","520","0","0.1192113709307657","0"
"SLA","16/5/2019","19","3069","19","92525","0","89456","0","29.14825676115999","0"
"SLA","17/5/2019","26","4229","26","224627","0","220398","0","52.11586663513833","0"
"SLA","18/5/2019","27","5017","26","256820","-1","251803","-0.037037037","50.18995415587004","0"
"SLA","19/5/2019","14","2724","13","2891","-1","167","-0.071428571","0.06130690161527166","0"
"SLA","20/5/2019","13","2422","12","88788","-1","86366","-0.076923076","35.65895953757225","0"
"SLA","21/5/2019","15","2880","16","53303","1","50423","0.066666666","17.507986111111112","0"
"SLA","22/5/2019","21","3965","21","54140","0","50175","0","12.654476670870114","0"
"SLA","23/5/2019","24","4238","25","143920","1","139682","0.041666666","32.95941481831052","0"
"SLA","24/5/2019","32","5296","32","275703","0","270407","0","51.05872356495468","0"
"SLA","25/5/2019","33","5405","33","190218","0","184813","0","34.19296947271045","0"
"SLA","26/5/2019","28","5870","27","91278","-1","85408","-0.035714285","14.54991482112436","0"
"SLA","27/5/2019","16","3647","16","4047","0","400","0","0.10967918837400603","0"
"SLA","28/5/2019","18","3865","18","4209","0","344","0","0.0890038809831824","0"
"SLA","29/5/2019","16","2855","16","3117","0","262","0","0.09176882661996498","0"
"SLA","30/5/2019","16","2556","16","141912","0","139356","0","54.521126760563384","0"
"SLA","31/5/2019","21","4740","21","4922","0","182","0","0.03839662447257384","0"
"SLA","1/6/2019","31","6151","31","7064","0","913","0","0.14843114940660054","0"
"SLA","2/6/2019","25","4947","26","6251","1","1304","0.04","0.26359409743278756","0"
"SLA","3/6/2019","0","16","0","0","0","-16",,"-1","0"
"SLA","4/6/2019","0","0","0","0","0","0",,,"0"
"SLA","5/6/2019","11","1652","11","1961","0","309","0","0.18704600484261502","0"
"SLA","6/6/2019","22","4327","22","152552","0","148225","0","34.25583545181419","0"
"SLA","7/6/2019","26","5321","26","275251","0","269930","0","50.72918624318737","0"
"SLA","8/6/2019","36","6378","37","203726","1","197348","0.027777777","30.941988084038883","0"
"SLA","9/6/2019","42","6665","41","6663","-1","-2","-0.023809523","-0.0003000750187546887","0"
"SLA","10/6/2019","35","5766","34","6620","-1","854","-0.028571428","0.14810960804717307","0"
"SLA","11/6/2019","27","6635","26","6286","-1","-349","-0.037037037","-0.05259984928409947","0"
"SLA","12/6/2019","34","6928","34","8187","0","1259","0","0.18172632794457275","0"
"SLA","13/6/2019","25","7209","25","5895","0","-1314","0","-0.1822721598002497","0"
"SLA","14/6/2019","23","4159","23","184462","0","180303","0","43.35248857898533","0"
"SLA","15/6/2019","29","5249","29","269178","0","263929","0","50.28176795580111","0"
"SLA","16/6/2019","14","2449","14","2737","0","288","0","0.1175990200081666","0"
"SLA","17/6/2019","14","2331","14","2594","0","263","0","0.11282711282711283","0"
"SLA","18/6/2019","18","4363","20","92492","2","88129","0.111111111","20.19917487966995","1"
"SLA","19/6/2019","30","4924","31","90130","1","85206","0.033333333","17.304224207961006","0"
"SLA","20/6/2019","47","8259","46","187930","-1","179671","-0.021276595","21.754570771279816","0"
"SLA","21/6/2019","51","9232","49","244341","-2","235109","-0.039215686","25.46674610051993","0"
"SLA","22/6/2019","52","10215","50","118613","-2","108398","-0.038461538","10.611649534997552","0"
"SLA","23/6/2019","43","7791","42","8678","-1","887","-0.023255813","0.11384931331022975","0"
"SLA","24/6/2019","29","5906","29","6422","0","516","0","0.08736877751439215","0"
"SLA","25/6/2019","30","5641","30","6369","0","728","0","0.12905513206878214","0"
"SLA","26/6/2019","31","6069","36","889951","5","883882","0.161290322","145.63882023397593","1"
"SLA","27/6/2019","32","6736","34","1912825","2","1906089","0.0625","282.97045724465556","0"
"SLA","28/6/2019","45","9294","45","3182541","0","3173247","0","341.4296320206585","0"
"SLA","29/6/2019","62","12274","62","3840126","0","3827852","0","311.8667101189506","0"
"SLA","30/6/2019","61","12114","66","3940935","5","3928821","0.081967213","324.3207033184745","0"
"SLA","1/7/2019","46","8174","47","9510","1","1336","0.02173913","0.1634450697333007","0"
"SLA","2/7/2019","44","7458","45","118456","1","110998","0.022727272","14.88307857334406","0"
"SLA","3/7/2019","53","10349","54","1969427","1","1959078","0.018867924","189.30118852063","0"
"SLA","4/7/2019","36","6570","40","7772","4","1202","0.111111111","0.18295281582952816","1"
"SLA","5/7/2019","31","5947","31","7033","0","1086","0","0.1826130822263326","0"
"SLA","6/7/2019","32","6072","34","150196","2","144124","0.0625","23.735836627140976","0"
"SLA","7/7/2019","36","6523","37","65942","1","59419","0.027777777","9.109152230568757","0"
"SLA","8/7/2019","30","6809","30","7208","0","399","0","0.05859891320311353","0"
"SLA","9/7/2019","44","9022","44","10456","0","1434","0","0.15894480159609842","0"
"SLA","10/7/2019","35","6450","37","7976","2","1526","0.057142857","0.2365891472868217","0"
"SLA","11/7/2019","43","8732","45","9359","2","627","0.046511627","0.0718048557031608","0"
"SLA","12/7/2019","40","7567","44","8655","4","1088","0.1","0.14378221223734639","1"
"SLA","13/7/2019","40","7784","44","8984","4","1200","0.1","0.15416238437821173","1"
"SLA","14/7/2019","38","7231","38","8036","0","805","0","0.11132623426911907","0"
"SLA","15/7/2019","36","6361","36","91873","0","85512","0","13.4431693130011","0"
"SLA","16/7/2019","29","4893","29","5444","0","551","0","0.1126098508072757","0"
"SLA","17/7/2019","31","6060","31","6523","0","463","0","0.0764026402640264","0"
"SLA","18/7/2019","33","5712","32","6488","-1","776","-0.03030303","0.13585434173669467","0"
"SLA","19/7/2019","27","4695","27","5127","0","432","0","0.09201277955271565","0"
"SLA","20/7/2019","37","6894","38","92844","1","85950","0.027027027","12.467362924281984","0"
"SLA","21/7/2019","30","5984","31","6680","1","696","0.033333333","0.1163101604278075","0"
"SLA","22/7/2019","35","7004","36","82479","1","75475","0.028571428","10.77598515134209","0"
"SLA","23/7/2019","31","5808","32","116191","1","110383","0.032258064","19.00533746556474","0"
"SLA","24/7/2019","29","4974","31","115918","2","110944","0.068965517","22.304784881383192","0"
"SLA","25/7/2019","30","5037","32","6610","2","1573","0.066666666","0.31228906094897757","0"
"SLA","26/7/2019","32","6182","33","6880","1","698","0.03125","0.11290844386929796","0"
"SLA","27/7/2019","29","5047","30","185846","1","180799","0.034482758","35.82306320586487","0"
"SLA","28/7/2019","38","8079","38","8613","0","534","0","0.06609728926847382","0"
"SLA","29/7/2019","34","6768","34","6420","0","-348","0","-0.051418439716312055","0"
"SLA","30/7/2019","42","11594","42","94489","0","82895","0","7.149818871830257","0"
"SLA","31/7/2019","34","4377","34","92961","0","88584","0","20.23851953392735","0"
"SLA","1/8/2019","34","5221","34","92491","0","87270","0","16.71518866117602","0"
"SLA","2/8/2019","34","6757","34","7412","0","655","0","0.09693651028562972","0"
"SLA","3/8/2019","38","7554","38","8632","0","1078","0","0.14270585120465978","0"
"SLA","4/8/2019","27","4971","27","5310","0","339","0","0.06819553409776705","0"
"SLA","5/8/2019","29","4582","29","5317","0","735","0","0.16041030117852467","0"
"SLA","6/8/2019","38","7239","38","194667","0","187428","0","25.891421467053462","0"
"SLA","7/8/2019","35","6586","35","83623","0","77037","0","11.697084725174612","0"
"SLA","8/8/2019","32","6649","32","7272","0","623","0","0.09369830049631524","0"
"SLA","9/8/2019","32","6954","32","7153","0","199","0","0.028616623526028184","0"
"SLA","10/8/2019","44","8410","44","10170","0","1760","0","0.20927467300832342","0"
"SLA","11/8/2019","27","4918","27","5788","0","870","0","0.17690117934119562","0"
"SLA","12/8/2019","26","4177","26","5333","0","1156","0","0.2767536509456548","0"
"SLA","13/8/2019","36","7689","36","7229","0","-460","0","-0.059825725061776566","0"
"SLA","14/8/2019","33","7592","33","6894","0","-698","0","-0.09193888303477345","0"
"SLA","15/8/2019","38","5898","38","153006","0","147108","0","24.94201424211597","0"
"SLA","16/8/2019","33","5506","33","350087","0","344581","0","62.58281874318925","0"
"SLA","17/8/2019","33","5406","33","90920","0","85514","0","15.818349981502035","0"
"SLA","18/8/2019","36","6482","36","7805","0","1323","0","0.2041036717062635","0"
"SLA","19/8/2019","30","5562","30","6502","0","940","0","0.1690039554117224","0"
"SLA","20/8/2019","42","7878","42","104418","0","96540","0","12.254379284082255","0"
"SLA","21/8/2019","22","3030","22","99862","0","96832","0","31.957755775577557","0"
"SLA","22/8/2019","27","4581","27","101238","0","96657","0","21.09954158480681","0"
"SLA","23/8/2019","32","5888","32","151911","0","146023","0","24.800101902173914","0"
"SLA","24/8/2019","42","6435","41","581973","-1","575538","-0.023809523","89.43869463869464","0"
"SLA","25/8/2019","30","5557","30","6123","0","566","0","0.10185351808529783","0"
"SLA","26/8/2019","38","7183","38","7769","0","586","0","0.08158151190310456","0"
"SLA","27/8/2019","27","5110","27","5413","0","303","0","0.05929549902152642","0"
"SLA","28/8/2019","36","7312","36","117020","0","109708","0","15.00382932166302","0"
"SLA","29/8/2019","40","6757","40","117467","0","110710","0","16.3844901583543","0"
"SLA","30/8/2019","50","8289","49","265220","-1","256931","-0.02","30.99662202919532","0"
"SLA","31/8/2019","41","6357","41","435562","0","429205","0","67.51691049237061","0"
"SLA","1/9/2019","22","3368","22","3987","0","619","0","0.18378859857482185","0"
"SLA","2/9/2019","25","4584","25","5322","0","738","0","0.16099476439790575","0"
"SLA","3/9/2019","33","5992","33","228251","0","222259","0","37.09262349799733","0"
"SLA","4/9/2019","32","5052","32","454585","0","449533","0","88.98119556611243","0"
"SLA","5/9/2019","37","6220","37","176638","0","170418","0","27.3983922829582","0"
"SLA","6/9/2019","44","8277","44","376145","0","367868","0","44.44460553340582","0"
"SLA","7/9/2019","53","9709","53","555799","0","546090","0","56.24575136471315","0"
"SLA","8/9/2019","51","9141","51","60470","0","51329","0","5.615249972650695","0"
"SLA","9/9/2019","49","9246","49","59293","0","50047","0","5.4128271685052995","0"
"SLA","10/9/2019","50","8795","50","59517","0","50722","0","5.7671404206935755","0"
"SLA","11/9/2019","41","7274","41","57275","0","50001","0","6.873934561451746","0"
"SLA","12/9/2019","33","6061","33","56107","0","50046","0","8.25705329153605","0"
"SLA","13/9/2019","32","5232","32","360870","0","355638","0","67.97362385321101","0"
"SLA","14/9/2019","45","7102","45","180188","0","173086","0","24.371444663475078","0"
"SLA","15/9/2019","37","6440","37","7656","0","1216","0","0.18881987577639753","0"
"SLA","16/9/2019","61","10582","61","11384","0","802","0","0.07578907578907579","0"
"SLA","17/9/2019","52","9967","52","99611","0","89644","0","8.99408046553627","0"
"SLA","18/9/2019","46","8545","46","9191","0","646","0","0.07559976594499708","0"
"SLA","19/9/2019","39","7599","39","8120","0","521","0","0.06856165284905909","0"
"SLA","20/9/2019","41","7169","41","8087","0","918","0","0.1280513321244246","0"
"SLA","21/9/2019","38","6930","38","7889","0","959","0","0.1383838383838384","0"
"SLA","22/9/2019","29","5785","29","6530","0","745","0","0.12878133102852204","0"
"SLA","23/9/2019","29","5723","30","6480","1","757","0.034482758","0.13227328324305435","0"
"SLA","24/9/2019","39","7187","39","8306","0","1119","0","0.1556977876721859","0"
"SLA","25/9/2019","29","6959","29","7314","0","355","0","0.05101307659146429","0"
"SLA","26/9/2019","30","5724","30","231424","0","225700","0","39.430468204053106","0"
"SLA","27/9/2019","42","7750","42","8236","0","486","0","0.06270967741935483","0"
"SLA","28/9/2019","45","7348","45","345668","0","338320","0","46.0424605334785","0"
"SLA","29/9/2019","50","9760","51","150604","1","140844","0.02","14.430737704918032","0"
"SLA","30/9/2019","46","8382","46","86567","0","78185","0","9.327726079694584","0"
"SLA","1/10/2019","48","8697","50","282105","2","273408","0.041666666","31.43704725767506","0"
"SLA","2/10/2019","42","7290","44","162630","2","155340","0.047619047","21.308641975308642","0"
"SLA","3/10/2019","42","7464","42","171255","0","163791","0","21.944131832797428","0"
"SLA","4/10/2019","29","8097","29","9013","0","916","0","0.11312831913054218","0"
"SLA","5/10/2019","41","11000","41","12130","0","1130","0","0.10272727272727272","0"
"SLA","6/10/2019","33","9640","33","10508","0","868","0","0.09004149377593361","0"
"SLA","7/10/2019","33","9004","34","10805","1","1801","0.03030303","0.20002221235006665","0"
"SLA","8/10/2019","41","11808","41","12590","0","782","0","0.06622628726287264","0"
"SLA","9/10/2019","35","10305","35","10738","0","433","0","0.042018437651625426","0"
"SLA","10/10/2019","34","9502","36","10990","2","1488","0.058823529","0.156598610818775","0"
"SLA","11/10/2019","41","11235","42","13180","1","1945","0.024390243","0.17311971517578995","0"
"SLA","12/10/2019","45","11159","45","325131","0","313972","0","28.136212922304868","0"
"SLA","13/10/2019","39","10239","39","11102","0","863","0","0.08428557476316047","0"
"SLA","14/10/2019","46","12481","46","1378369","0","1365888","0","109.4373848249339","0"
"SLA","15/10/2019","47","12318","47","1378181","0","1365863","0","110.88350381555448","0"
"SLA","16/10/2019","32","7763","32","168947","0","161184","0","20.763107046245008","0"
"SLA","17/10/2019","38","8611","38","9173","0","562","0","0.06526535826268726","0"
"SLA","18/10/2019","60","15408","60","19226","0","3818","0","0.2477933541017653","0"
"SLA","19/10/2019","43","11311","49","12149","6","838","0.139534883","0.07408717177968349","1"
"SLA","20/10/2019","0","19446","7","950","7","-18496",,"-0.951146765401625","0"
"SLA","21/10/2019","0","9123","1","335","1","-8788",,"-0.9632796229310534","0"
"SLA","22/10/2019","8","4074","10","2873","2","-1201","0.25","-0.29479626902307315","1"
"SLA","23/10/2019","11","5226","13","4099","2","-1127","0.181818181","-0.2156525066972828","1"
"SLA","24/10/2019","0","5632","8","1222","8","-4410",,"-0.7830255681818182","0"
"SLA","25/10/2019","0","4155","6","983","6","-3172",,"-0.7634175691937425","0"
"SLA","26/10/2019","0","4286","1","335","1","-3951",,"-0.9218385440970602","0"
"SLA","27/10/2019","0","1422","1","500","1","-922",,"-0.6483825597749648","0"
"SLA","28/10/2019","11","-35440","14","4311","3","39751","0.272727272","-1.1216422121896163","1"
"SLA","29/10/2019","14","-1971","15","4414","1","6385","0.071428571","-3.23947234906139","0"
"SLA","30/10/2019","14","3586","18","4736","4","1150","0.285714285","0.32069157836029","1"
"SLA","31/10/2019","17","4446","23","6357","6","1911","0.352941176","0.4298245614035088","1"
"SLA","1/11/2019","16","3605","21","7094","5","3489","0.3125","0.9678224687933425","1"
"SLA","2/11/2019","11","3070","17","4736","6","1666","0.545454545","0.542671009771987","1"
"SLA","3/11/2019","30","7252","33","1338339","3","1331087","0.1","183.54757308328738","1"
"SLA","4/11/2019","31","12316","36","1339248","5","1326932","0.161290322","107.74050016239039","1"
"SLA","5/11/2019","38","9632","40","1499610","2","1489978","0.052631578","154.69040697674419","0"
"SLA","6/11/2019","29","6631","31","1437466","2","1430835","0.068965517","215.7796712411401","0"
"SLA","7/11/2019","25","5623","27","1335896","2","1330273","0.08","236.57709407789437","0"
"SLA","8/11/2019","29","6147","33","1338541","4","1332394","0.137931034","216.75516512119734","1"
"SLA","9/11/2019","29","7656","31","1337919","2","1330263","0.068965517","173.7543103448276","0"
"SLA","10/11/2019","26","6440","27","1336955","1","1330515","0.038461538","206.60170807453417","0"
"SLA","11/11/2019","23","5621","27","1337407","4","1331786","0.173913043","236.93043942359012","1"
"SLA","12/11/2019","14","4022","17","142735","3","138713","0.214285714","34.488562904027845","1"
"SLA","13/11/2019","16","4520","17","5355","1","835","0.0625","0.1847345132743363","0"
"SLA","14/11/2019","27","7023","33","9482","6","2459","0.222222222","0.350135269827709","1"
"SLA","15/11/2019","17","7128","24","7294","7","166","0.411764705","0.023288439955106623","1"
"SLA","16/11/2019","21","6733","31","9745","10","3012","0.476190476","0.4473488786573593","1"
"SLA","17/11/2019","26","7298","33","9169","7","1871","0.269230769","0.2563716086599068","1"
"SLA","18/11/2019","11","2429","29","6442","18","4013","1.636363636","1.6521202140798683","1"
"SLA","19/11/2019","14","4174","17","5229","3","1055","0.214285714","0.2527551509343555","1"
"SLA","20/11/2019","14","4194","16","4678","2","484","0.142857142","0.11540295660467334","1"
"SLA","21/11/2019","24","6480","26","6879","2","399","0.083333333","0.06157407407407407","0"
"SLA","22/11/2019","29","6713","30","10037","1","3324","0.034482758","0.4951586474005661","0"
"SLA","23/11/2019","14","4518","19","6846","5","2328","0.357142857","0.5152722443559097","1"
"SLA","24/11/2019","15","4335","15","4468","0","133","0","0.030680507497116493","0"
"SLA","25/11/2019","19","6644","20","5994","1","-650","0.052631578","-0.09783263094521373","0"
"SLA","26/11/2019","19","5073","19","5005","0","-68","0","-0.013404297260003943","0"
"SLA","27/11/2019","20","3593","21","6179","1","2586","0.05","0.7197328138046201","0"
"SLA","28/11/2019","21","5914","28","91639","7","85725","0.333333333","14.49526547176192","1"
"SLA","29/11/2019","33","10117","34","10830","1","713","0.03030303","0.07047543738262331","0"
"SLA","30/11/2019","19","5634","20","6478","1","844","0.052631578","0.14980475683351083","0"
"SLA","1/12/2019","24","8290","24","8359","0","69","0","0.008323281061519904","0"
"SLA","2/12/2019","14","4850","14","89346","0","84496","0","17.421855670103092","0"
"SLA","3/12/2019","17","2180","17","3788","0","1608","0","0.7376146788990826","0"
"SLA","4/12/2019","12","2335","12","91121","0","88786","0","38.02398286937901","0"
"SLA","5/12/2019","25","6661","26","6738","1","77","0.04","0.011559825851974178","0"
"SLA","6/12/2019","29","7568","30","11406","1","3838","0.034482758","0.5071353065539113","0"
"SLA","7/12/2019","25","7935","26","9535","1","1600","0.04","0.20163831127914303","0"
"SLA","8/12/2019","13","5275","13","5562","0","287","0","0.05440758293838863","0"
"SLA","9/12/2019","20","6372","20","6805","0","433","0","0.06795354676710609","0"
"SLA","10/12/2019","23","6251","24","6875","1","624","0.04347826","0.09982402815549513","0"
"SLA","11/12/2019","15","4167","16","93799","1","89632","0.066666666","21.50995920326374","0"
"SLA","12/12/2019","19","5766","18","6323","-1","557","-0.052631578","0.0966007630939993","0"
"SLA","13/12/2019","25","8005","26","8900","1","895","0.04","0.11180512179887571","0"
"SLA","14/12/2019","25","7577","25","8757","0","1180","0","0.15573445954863402","0"
"SLA","15/12/2019","24","7353","24","7909","0","556","0","0.07561539507683938","0"
"SLA","16/12/2019","15","5602","15","4402","0","-1200","0","-0.21420921099607282","0"
"SLA","17/12/2019","10","3278","10","3232","0","-46","0","-0.014032946918852958","0"
"SLA","18/12/2019","13","2878","13","3855","0","977","0","0.3394718554551772","0"
"SLA","19/12/2019","31","8844","34","98461","3","89617","0.096774193","10.133084577114428","0"
"SLA","20/12/2019","41","11192","45","16232","4","5040","0.097560975","0.4503216583273767","0"
"SLA","21/12/2019","21","6214","31","9999","10","3785","0.476190476","0.6091084647570003","1"
"SLA","22/12/2019","19","3974","35","10461","16","6487","0.842105263","1.632360342224459","1"
"SLA","23/12/2019","31","9476","35","11627","4","2151","0.129032258","0.22699451245251162","1"
"SLA","24/12/2019","21","6477","21","7136","0","659","0","0.10174463486181874","0"
"SLA","25/12/2019","25","7856","28","8984","3","1128","0.12","0.14358452138492872","1"
"SLA","26/12/2019","38","11727","41","13314","3","1587","0.078947368","0.13532872857508313","0"
"SLA","27/12/2019","53","15738","56","17697","3","1959","0.056603773","0.12447579107891726","0"
"SLA","28/12/2019","51","17070","57","137176","6","120106","0.117647058","7.036086701816052","1"
"SLA","29/12/2019","34","11067","37","13092","3","2025","0.088235294","0.1829764163730008","0"
"SLA","30/12/2019","41","11244","46","105358","5","94114","0.121951219","8.370152970473141","1"
"SLA","31/12/2019","44","14467","51","16924","7","2457","0.159090909","0.1698347964332619","1"
"SLA","1/1/2020","44","12578","45","14764","1","2186","0.022727272","0.17379551598028303","0"
"SLA","2/1/2020","47","13333","59","16772","12","3439","0.255319148","0.2579314482862072","1"
"SLA","3/1/2020","59","17190","60","18804","1","1614","0.016949152","0.09389179755671902","0"
"SLA","4/1/2020","59","17793","66","21119","7","3326","0.118644067","0.18692744337660877","1"
"SLA","5/1/2020","57","16267","57","18017","0","1750","0","0.10757976270978054","0"
"SLA","6/1/2020","37","11160","39","13079","2","1919","0.054054054","0.17195340501792114","0"
"SLA","7/1/2020","47","13499","49","14832","2","1333","0.042553191","0.09874805541151196","0"
"SLA","8/1/2020","55","14878","59","102370","4","87492","0.072727272","5.880629116816777","0"
"SLA","9/1/2020","49","10657","50","15315","1","4658","0.020408163","0.43708360701886084","0"
"SLA","10/1/2020","48","14521","50","17705","2","3184","0.041666666","0.21926864541009572","0"
"SLA","11/1/2020","35","10196","41","11731","6","1535","0.171428571","0.15054923499411535","1"
"SLA","12/1/2020","28","7991","34","10099","6","2108","0.214285714","0.2637967713677888","1"
"SLA","13/1/2020","28","9123","32","195941","4","186818","0.142857142","20.477693741093937","1"
"SLA","14/1/2020","30","8482","32","9411","2","929","0.066666666","0.10952605517566612","0"
"SLA","15/1/2020","40","10822","40","12288","0","1466","0","0.13546479393827388","0"
"SLA","16/1/2020","31","9355","34","99500","3","90145","0.096774193","9.636023516835916","0"
"SLA","17/1/2020","28","8607","28","9390","0","783","0","0.09097246427326594","0"
"SLA","18/1/2020","44","12936","44","14156","0","1220","0","0.0943104514533086","0"
"SLA","19/1/2020","37","10023","37","11165","0","1142","0","0.11393794273171705","0"
"SLA","20/1/2020","44","12019","44","13280","0","1261","0","0.10491721441051668","0"
"SLA","21/1/2020","39","9289","41","11996","2","2707","0.051282051","0.29141995909139845","0"
"SLA","22/1/2020","51","13335","51","1443761","0","1430426","0","107.26854143232096","0"
"SLA","23/1/2020","55","14648","56","157588","1","142940","0.018181818","9.758328782086291","0"
"SLA","24/1/2020","61","15225","62","21020","1","5795","0.016393442","0.380623973727422","0"
"SLA","25/1/2020","36","11131","38","13337","2","2206","0.055555555","0.19818524840535442","0"
"SLA","26/1/2020","40","13780","40","14332","0","552","0","0.04005805515239477","0"
"SLA","27/1/2020","27","7862","29","9588","2","1726","0.074074074","0.2195370134825744","0"
"SLA","28/1/2020","33","10636","36","11553","3","917","0.09090909","0.08621662279052275","0"
"SLA","29/1/2020","35","9587","35","10996","0","1409","0","0.14696985501199542","0"
"SLA","30/1/2020","31","7902","31","98030","0","90128","0","11.405720070868135","0"
"SLA","31/1/2020","29","14645","29","9948","0","-4697","0","-0.3207237965175828","0"
"SLA","1/2/2020","43","12983","43","14512","0","1529","0","0.1177693907417392","0"
"SLA","2/2/2020","38","11969","39","13076","1","1107","0.026315789","0.09248892973514913","0"
"SLA","3/2/2020","46","14104","47","14988","1","884","0.02173913","0.06267725467952354","0"
"SLA","4/2/2020","52","14655","51","104475","-1","89820","-0.019230769","6.1289662231320365","0"
"SLA","5/2/2020","34","8328","34","9487","0","1159","0","0.13916906820365033","0"
"SLA","6/2/2020","35","9671","33","9637","-2","-34","-0.057142857","-0.0035156653913762798","0"
"SLA","7/2/2020","50","12040","49","16689","-1","4649","-0.02","0.38612956810631227","0"
"SLA","8/2/2020","36","10411","37","10905","1","494","0.027777777","0.047449812698107774","0"
"SLA","9/2/2020","46","13837","46","13908","0","71","0","0.0051311700513117006","0"
"SLA","10/2/2020","34","9288","33","9534","-1","246","-0.029411764","0.02648578811369509","0"
"SLA","11/2/2020","39","11072","38","11322","-1","250","-0.025641025","0.022579479768786128","0"
"SLA","12/2/2020","41","10466","39","11135","-2","669","-0.048780487","0.0639212688706287","0"
"SLA","13/2/2020","52","12095","48","101579","-4","89484","-0.076923076","7.398429102935097","0"
"SLA","14/2/2020","50","12268","45","561641","-5","549373","-0.1","44.78097489403326","1"
"SLA","15/2/2020","48","13613","31","427279","-17","413666","-0.354166666","30.387570704473664","1"
"SLA","16/2/2020","44","12551","44","13569","0","1018","0","0.08110907497410565","0"
"SLA","17/2/2020","32","9359","34","10440","2","1081","0.0625","0.11550379314029277","0"
"SLA","18/2/2020","38","11449","37","11590","-1","141","-0.026315789","0.012315486068652284","0"
"SLA","19/2/2020","34","8870","33","10267","-1","1397","-0.029411764","0.15749718151071027","0"
"SLA","20/2/2020","31","8514","30","9364","-1","850","-0.032258064","0.09983556495184402","0"
"SLA","21/2/2020","31","10565","28","8783","-3","-1782","-0.096774193","-0.16867013724562233","0"
"SLA","22/2/2020","44","13124","46","13786","2","662","0.045454545","0.05044193843340445","0"
"SLA","23/2/2020","43","12818","42","13393","-1","575","-0.023255813","0.044858792323295364","0"
"SLA","24/2/2020","38","11552","37","11557","-1","5","-0.026315789","0.0004328254847645429","0"
"SLA","25/2/2020","43","11819","40","12078","-3","259","-0.069767441","0.021913867501480666","0"
"SLA","26/2/2020","36","9210","35","99496","-1","90286","-0.027777777","9.803040173724213","0"
"SLA","27/2/2020","39","10357","39","10969","0","612","0","0.059090470213382255","0"
"SLA","28/2/2020","33","9659","33","9797","0","138","0","0.014287193291230977","0"
"SLA","29/2/2020","40","11359","41","12140","1","781","0.025","0.06875605246940752","0"
"SLA","1/3/2020","29","8399","30","8385","1","-14","0.034482758","-0.0016668651029884511","0"
"SLA","2/3/2020","28","6450","27","7229","-1","779","-0.035714285","0.12077519379844961","0"
"SLA","3/3/2020","27","7802","27","7699","0","-103","0","-0.013201743142783901","0"
"SLA","4/3/2020","22","5399","21","5682","-1","283","-0.045454545","0.0524171142804223","0"
"SLA","5/3/2020","28","6480","27","95837","-1","89357","-0.035714285","13.78966049382716","0"
"SLA","6/3/2020","42","10298","40","13434","-2","3136","-0.047619047","0.30452515051466306","0"
"SLA","7/3/2020","29","7565","23","6322","-6","-1243","-0.206896551","-0.1643093192333113","1"
"SLA","8/3/2020","24","5688","20","5271","-4","-417","-0.166666666","-0.07331223628691984","1"
"SLA","9/3/2020","27","5672","25","5597","-2","-75","-0.074074074","-0.013222849083215797","0"
"SLA","10/3/2020","21","6521","22","6223","1","-298","0.047619047","-0.04569851249808311","0"
"SLA","11/3/2020","14","2988","16","4790","2","1802","0.142857142","0.6030789825970548","1"
"SLA","12/3/2020","23","4907","24","95142","1","90235","0.04347826","18.389036070919094","0"
"SLA","13/3/2020","21","5445","20","5207","-1","-238","-0.047619047","-0.04370982552800735","0"
"SLA","14/3/2020","21","5535","21","5718","0","183","0","0.033062330623306234","0"
"SLA","15/3/2020","23","6245","21","5889","-2","-356","-0.086956521","-0.057005604483586866","0"
"SLA","16/3/2020","17","5098","11","2517","-6","-2581","-0.352941176","-0.5062769713613182","1"
"SLA","17/3/2020","19","5174","17","4481","-2","-693","-0.105263157","-0.13393892539621183","1"
"SLA","18/3/2020","11","3094","11","2932","0","-162","0","-0.05235940530058177","0"
"SLA","19/3/2020","13","3552","13","3498","0","-54","0","-0.015202702702702704","0"
"SLA","20/3/2020","9","1928","9","2173","0","245","0","0.1270746887966805","0"
"SLA","21/3/2020","8","1627","8","1750","0","123","0","0.07559926244622003","0"
"SLA","22/3/2020","7","1381","7","1732","0","351","0","0.2541636495293266","0"
"SLA","23/3/2020","2","-65","2","186","0","251","0","-3.8615384615384616","0"
"SLA","24/3/2020","0","-379","0","0","0","379",,"-1","0"
"SLA","25/3/2020","0","-53","0","0","0","53",,"-1","0"
"SLA","26/3/2020","0","-53","0","0","0","53",,"-1","0"
"SLA","27/3/2020","0","-53","1","272","1","325",,"-6.132075471698113","0"
"SLA","28/3/2020","0","-53","1","272","1","325",,"-6.132075471698113","0"
"SLA","29/3/2020","0","-53","0","0","0","53",,"-1","0"
"SLA","30/3/2020","0","-53","0","0","0","53",,"-1","0"
"SLA","31/3/2020","0","-52","0","0","0","52",,"-1","0"
"SLA","1/4/2020","0","-52","0","0","0","52",,"-1","0"
"SLA","2/4/2020","0","-52","0","0","0","52",,"-1","0"
"SLA","3/4/2020","0","-52","0","0","0","52",,"-1","0"
"SLA","4/4/2020","0","-52","0","0","0","52",,"-1","0"
"SLA","5/4/2020","0","-52","0","0","0","52",,"-1","0"
"SLA","6/4/2020","0","-52","0","0","0","52",,"-1","0"
"SLA","7/4/2020","0","-52","0","0","0","52",,"-1","0"
"SLA","8/4/2020","0","-53","0","0","0","53",,"-1","0"
"SLA","9/4/2020","0","-53","0","0","0","53",,"-1","0"
"SLA","10/4/2020","0","-53","0","0","0","53",,"-1","0"
"SLA","11/4/2020","0","4931","0","0","0","-4931",,"-1","0"
"SLA","12/4/2020","0","-52","0","0","0","52",,"-1","0"
"SLA","13/4/2020","0","-597","0","0","0","597",,"-1","0"
"SLA","14/4/2020","0","-25","0","0","0","25",,"-1","0"
"SLA","15/4/2020","0","-46","0","0","0","46",,"-1","0"
"SLA","16/4/2020","0","-25","0","0","0","25",,"-1","0"
"SLA","17/4/2020","0","-25","0","0","0","25",,"-1","0"
"SLA","18/4/2020","0","-25","0","0","0","25",,"-1","0"
"SLA","19/4/2020","0","-9","0","0","0","9",,"-1","0"
"SLA","20/4/2020","0","-321","0","0","0","321",,"-1","0"
"SLA","21/4/2020","0","-253","0","0","0","253",,"-1","0"
"SLA","22/4/2020","0","-25","0","0","0","25",,"-1","0"
"SLA","23/4/2020","0","-25","0","0","0","25",,"-1","0"
"SLA","24/4/2020","0","-25","0","0","0","25",,"-1","0"
"SLA","25/4/2020","0","-25","0","0","0","25",,"-1","0"
"SLA","26/4/2020","0","316","0","0","0","-316",,"-1","0"
"SLA","27/4/2020","0","-25","0","0","0","25",,"-1","0"
"SLA","28/4/2020","0","24","0","0","0","-24",,"-1","0"
"SLA","29/4/2020","0","-26","0","0","0","26",,"-1","0"
"SLA","30/4/2020","0","-26","0","0","0","26",,"-1","0"
"SLA","1/5/2020","0","-26","0","0","0","26",,"-1","0"
"SLA","2/5/2020","0","-26","0","0","0","26",,"-1","0"
"SLA","3/5/2020","0","-26","0","0","0","26",,"-1","0"
"SLA","4/5/2020","0","-26","0","0","0","26",,"-1","0"
"SLA","5/5/2020","0","-26","0","0","0","26",,"-1","0"
"SLA","6/5/2020","0","-26","0","0","0","26",,"-1","0"
"SLA","7/5/2020","0","-26","0","0","0","26",,"-1","0"
"SLA","8/5/2020","0","-26","0","0","0","26",,"-1","0"
"SLA","9/5/2020","0","-26","0","0","0","26",,"-1","0"
"SLA","10/5/2020","0","-26","0","0","0","26",,"-1","0"
"SLA","11/5/2020","0","-26","0","0","0","26",,"-1","0"
"SLA","12/5/2020","0","-26","0","0","0","26",,"-1","0"
"SLA","13/5/2020","0","-26","0","0","0","26",,"-1","0"
"SLA","14/5/2020","0","-26","0","0","0","26",,"-1","0"
"SLA","15/5/2020","0","-26","0","0","0","26",,"-1","0"
"SLA","16/5/2020","0","-2737","0","0","0","2737",,"-1","0"
"SLA","17/5/2020","0","0","0","0","0","0",,,"0"
"SLA","18/5/2020","0","-3096","0","0","0","3096",,"-1","0"
"SLA","19/5/2020","0","-598","0","0","0","598",,"-1","0"
"SLA","20/5/2020","0","0","0","0","0","0",,,"0"
"SLA","21/5/2020","0","0","0","0","0","0",,,"0"
"SLA","22/5/2020","0","0","0","0","0","0",,,"0"
"SLA","23/5/2020","0","0","0","0","0","0",,,"0"
"SLA","24/5/2020","0","-391","0","0","0","391",,"-1","0"
"SLA","25/5/2020","0","458","0","0","0","-458",,"-1","0"
"SLA","26/5/2020","0","-832","0","0","0","832",,"-1","0"
"SLA","27/5/2020","0","0","0","0","0","0",,,"0"
"SLA","28/5/2020","0","0","0","0","0","0",,,"0"
"SLA","29/5/2020","0","0","0","0","0","0",,,"0"
"SLA","30/5/2020","0","0","0","0","0","0",,,"0"
"SLA","31/5/2020","0","0","0","0","0","0",,,"0"
"SLA","1/6/2020","0","0","0","0","0","0",,,"0"
"SLA","2/6/2020","0","0","0","0","0","0",,,"0"
"SLA","3/6/2020","0","0","0","0","0","0",,,"0"
"SLA","4/6/2020","0","0","0","0","0","0",,,"0"
"SLA","5/6/2020","0","0","0","0","0","0",,,"0"
"SLA","6/6/2020","0","0","0","0","0","0",,,"0"
"SLA","7/6/2020","0","0","0","0","0","0",,,"0"
"SLA","8/6/2020","0","0","0","0","0","0",,,"0"
"SLA","9/6/2020","0","0","0","0","0","0",,,"0"
"SLA","10/6/2020","0","0","0","0","0","0",,,"0"
"SLA","11/6/2020","0","0","0","0","0","0",,,"0"
"SLA","12/6/2020","0","0","0","0","0","0",,,"0"
"SLA","13/6/2020","1","134","1","134","0","0","0","0","0"
"SLA","14/6/2020","0","0","0","0","0","0",,,"0"
"SLA","15/6/2020","0","0","0","0","0","0",,,"0"
"SLA","16/6/2020","0","0","0","0","0","0",,,"0"
"SLA","17/6/2020","0","0","0","0","0","0",,,"0"
"SLA","18/6/2020","0","0","0","0","0","0",,,"0"
"SLA","19/6/2020","0","0","0","0","0","0",,,"0"
"SLA","20/6/2020","0","0","0","0","0","0",,,"0"
"SLA","21/6/2020","2","258","2","258","0","0","0","0","0"
"SLA","22/6/2020","2","258","2","258","0","0","0","0","0"
"SLA","23/6/2020","2","258","2","258","0","0","0","0","0"
"SLA","24/6/2020","1","119","1","119","0","0","0","0","0"
"SLA","25/6/2020","0","0","0","0","0","0",,,"0"
"SLA","26/6/2020","0","0","0","0","0","0",,,"0"
"SLA","27/6/2020","0","0","0","0","0","0",,,"0"
"SLA","28/6/2020","0","0","0","0","0","0",,,"0"
"SLA","29/6/2020","0","0","0","0","0","0",,,"0"
"SLA","30/6/2020","0","0","0","0","0","0",,,"0"
"SLA","1/7/2020","0","0","0","0","0","0",,,"0"
"SLA","2/7/2020","0","0","0","0","0","0",,,"0"
"SLA","3/7/2020","1","219","1","219","0","0","0","0","0"
"SLA","4/7/2020","1","219","1","219","0","0","0","0","0"
"SLA","5/7/2020","0","0","0","0","0","0",,,"0"
"SLA","6/7/2020","0","0","0","0","0","0",,,"0"
"SLA","7/7/2020","0","0","0","0","0","0",,,"0"
"SLA","8/7/2020","0","0","0","0","0","0",,,"0"
"SLA","9/7/2020","0","0","0","0","0","0",,,"0"
"SLA","10/7/2020","0","0","0","0","0","0",,,"0"
"SLA","11/7/2020","0","0","0","0","0","0",,,"0"
"SLA","12/7/2020","0","0","0","0","0","0",,,"0"
"SLA","13/7/2020","0","0","0","0","0","0",,,"0"
"SLA","14/7/2020","0","0","0","0","0","0",,,"0"
"SLA","15/7/2020","0","0","0","0","0","0",,,"0"
"SLA","16/7/2020","0","0","0","0","0","0",,,"0"
"SLA","17/7/2020","0","0","0","0","0","0",,,"0"
"SLA","18/7/2020","0","0","0","0","0","0",,,"0"
"SLA","19/7/2020","0","0","0","0","0","0",,,"0"
"SLA","20/7/2020","0","0","0","0","0","0",,,"0"
"SLA","21/7/2020","0","0","0","0","0","0",,,"0"
"SLA","22/7/2020","0","0","0","0","0","0",,,"0"
"SLA","23/7/2020","0","0","0","0","0","0",,,"0"
"SLA","24/7/2020","0","0","0","0","0","0",,,"0"
"SLA","25/7/2020","0","0","0","0","0","0",,,"0"
"SLA","26/7/2020","0","0","0","0","0","0",,,"0"
"SLA","27/7/2020","0","0","0","0","0","0",,,"0"
"SLA","28/7/2020","0","0","0","0","0","0",,,"0"
"SLA","29/7/2020","0","0","0","0","0","0",,,"0"
"SLA","30/7/2020","0","0","0","0","0","0",,,"0"
"SLA","31/7/2020","0","0","0","0","0","0",,,"0"
"SLA","1/8/2020","0","0","0","0","0","0",,,"0"
"SLA","2/8/2020","0","0","0","0","0","0",,,"0"
"SLA","3/8/2020","0","0","0","0","0","0",,,"0"
"SLA","4/8/2020","0","0","0","0","0","0",,,"0"
"SLA","5/8/2020","0","0","0","0","0","0",,,"0"
"SLA","6/8/2020","0","0","0","0","0","0",,,"0"
"SLA","7/8/2020","0","0","0","0","0","0",,,"0"
"SLA","8/8/2020","0","0","0","0","0","0",,,"0"
"SLA","9/8/2020","0","0","0","0","0","0",,,"0"
"SLA","10/8/2020","0","0","0","0","0","0",,,"0"
"SLA","11/8/2020","0","0","0","0","0","0",,,"0"
"SLA","12/8/2020","0","0","0","0","0","0",,,"0"
"SLA","13/8/2020","0","0","0","0","0","0",,,"0"
"SLA","14/8/2020","0","0","0","0","0","0",,,"0"
"SLA","15/8/2020","0","0","0","0","0","0",,,"0"
"SLA","16/8/2020","0","0","0","0","0","0",,,"0"
"SLA","17/8/2020","0","0","0","0","0","0",,,"0"
"SLA","18/8/2020","0","0","0","0","0","0",,,"0"
"SLA","19/8/2020","0","0","0","0","0","0",,,"0"
"SLA","20/8/2020","0","0","0","0","0","0",,,"0"
"SLA","21/8/2020","0","0","0","0","0","0",,,"0"
"SLA","22/8/2020","1","217","1","244","0","27","0","0.12442396313364056","0"
"SLA","23/8/2020","0","0","0","0","0","0",,,"0"
"SLA","24/8/2020","0","0","0","0","0","0",,,"0"
"SLA","25/8/2020","0","0","0","0","0","0",,,"0"
"SLA","26/8/2020","0","0","0","0","0","0",,,"0"
"SLA","27/8/2020","0","0","0","0","0","0",,,"0"
"SLA","28/8/2020","0","0","0","0","0","0",,,"0"
"SLA","29/8/2020","0","0","0","0","0","0",,,"0"
"SLA","30/8/2020","0","0","0","0","0","0",,,"0"
"SLA","31/8/2020","1","217","1","244","0","27","0","0.12442396313364056","0"
"SLA","1/9/2020","0","0","0","0","0","0",,,"0"
"SLA","2/9/2020","0","0","0","0","0","0",,,"0"
"SLA","3/9/2020","0","0","0","0","0","0",,,"0"
"SLA","4/9/2020","0","0","0","0","0","0",,,"0"
"SLA","5/9/2020","0","0","0","0","0","0",,,"0"
"SLA","6/9/2020","1","179","1","206","0","27","0","0.15083798882681565","0"
"SLA","7/9/2020","1","179","1","206","0","27","0","0.15083798882681565","0"
"SLA","8/9/2020","1","179","1","206","0","27","0","0.15083798882681565","0"
"SLA","9/9/2020","0","0","0","0","0","0",,,"0"
"SLA","10/9/2020","0","0","0","0","0","0",,,"0"
"SLA","11/9/2020","0","0","0","0","0","0",,,"0"
"SLA","12/9/2020","0","0","0","0","0","0",,,"0"
"SLA","13/9/2020","0","0","0","0","0","0",,,"0"
"SLA","14/9/2020","0","0","0","0","0","0",,,"0"
"SLA","15/9/2020","0","0","0","0","0","0",,,"0"
"SLA","16/9/2020","0","0","0","0","0","0",,,"0"
"SLA","17/9/2020","0","0","0","0","0","0",,,"0"
"SLA","18/9/2020","0","0","0","0","0","0",,,"0"
"SLA","19/9/2020","0","0","0","0","0","0",,,"0"
"SLA","20/9/2020","0","0","0","0","0","0",,,"0"
"SLA","21/9/2020","0","0","0","0","0","0",,,"0"
"SLA","22/9/2020","6","179","1","179","-5","0","-0.833333333","0","1"
"SLA","23/9/2020","8","508","3","549","-5","41","-0.625","0.08070866141732283","1"
"SLA","24/9/2020","4","726","4","793","0","67","0","0.09228650137741047","0"
"SLA","25/9/2020","0","0","0","0","0","0",,,"0"
"SLA","26/9/2020","2","373","2","426","0","53","0","0.14209115281501342","0"
"SLA","27/9/2020","15","2519","4","646","-11","-1873","-0.733333333","-0.7435490273918222","1"
"SLA","28/9/2020","13","2333","2","220","-11","-2113","-0.846153846","-0.9057008144020574","1"
"SLA","29/9/2020","0","0","0","0","0","0",,,"0"
"SLA","30/9/2020","2","415","2","469","0","54","0","0.13012048192771083","0"
"SLA","1/10/2020","2","333","2","360","0","27","0","0.08108108108108109","0"
"SLA","2/10/2020","7","1746","7","1907","0","161","0","0.09221076746849943","0"
"SLA","3/10/2020","8","1715","8","1876","0","161","0","0.09387755102040816","0"
"SLA","4/10/2020","6","1520","6","1628","0","108","0","0.07105263157894737","0"
"SLA","5/10/2020","7","1799","7","1960","0","161","0","0.08949416342412451","0"
"SLA","6/10/2020","3","673","3","727","0","54","0","0.08023774145616643","0"
"SLA","7/10/2020","7","1304","7","654","0","-650","0","-0.49846625766871167","0"
"SLA","8/10/2020","12","1014","2","426","-10","-588","-0.833333333","-0.5798816568047337","1"
"SLA","9/10/2020","18","2746","8","2360","-10","-386","-0.555555555","-0.14056809905316825","1"
"SLA","10/10/2020","24","5195","4","1523","-20","-3672","-0.833333333","-0.7068334937439846","1"
"SLA","11/10/2020","27","6096","7","1033","-20","-5063","-0.74074074","-0.8305446194225722","1"
"SLA","12/10/2020","11","2979","4","822","-7","-2157","-0.636363636","-0.7240684793554885","1"
"SLA","13/10/2020","20","5102","5","1111","-15","-3991","-0.75","-0.7822422579380635","1"
"SLA","14/10/2020","22","5615","3","696","-19","-4919","-0.863636363","-0.876046304541407","1"
"SLA","15/10/2020","28","3516","8","696","-20","-2820","-0.714285714","-0.8020477815699659","1"
"SLA","16/10/2020","23","5247","3","1309","-20","-3938","-0.869565217","-0.750524109014675","1"
"SLA","17/10/2020","15","3798","11","3586","-4","-212","-0.266666666","-0.055818852027382834","1"
"SLA","18/10/2020","15","3849","11","3609","-4","-240","-0.266666666","-0.06235385814497272","1"
"SLA","19/10/2020","3","966","3","349","0","-617","0","-0.6387163561076604","0"
"SLA","20/10/2020","16","4201","8","868","-8","-3333","-0.5","-0.793382527969531","1"
"SLA","21/10/2020","21","6087","13","2888","-8","-3199","-0.38095238","-0.5255462460982422","1"
"SLA","22/10/2020","34","7129","15","3070","-19","-4059","-0.558823529","-0.5693645672604853","1"
"SLA","23/10/2020","19","3346","9","2906","-10","-440","-0.526315789","-0.1315002988643156","1"
"SLA","24/10/2020","5","1429","5","1510","0","81","0","0.05668299510146956","0"
"SLA","25/10/2020","10","3039","10","2609","0","-430","0","-0.14149391247120763","0"
"SLA","26/10/2020","8","2236","8","1739","0","-497","0","-0.22227191413237926","0"
"SLA","27/10/2020","11","3085","11","3017","0","-68","0","-0.022042139384116692","0"
"SLA","28/10/2020","15","4362","14","3563","-1","-799","-0.066666666","-0.18317285648784962","0"
"SLA","29/10/2020","26","6762","15","4213","-11","-2549","-0.423076923","-0.3769594794439515","1"
"SLA","30/10/2020","26","5891","6","2047","-20","-3844","-0.769230769","-0.6525207944321847","1"
"SLA","31/10/2020","9","2895","9","2062","0","-833","0","-0.2877374784110535","0"
"SLA","1/11/2020","13","1846","8","2033","-5","187","-0.384615384","0.10130010834236186","1"
"SLA","2/11/2020","5","1562","5","1669","0","107","0","0.06850192061459667","0"
"SLA","3/11/2020","14","3409","6","1682","-8","-1727","-0.571428571","-0.5066001760046934","1"
"SLA","4/11/2020","11","2710","3","930","-8","-1780","-0.727272727","-0.6568265682656826","1"
"SLA","5/11/2020","23","3871","4","1257","-19","-2614","-0.826086956","-0.6752777060191165","1"
"SLA","6/11/2020","18","3003","3","968","-15","-2035","-0.833333333","-0.6776556776556777","1"
"SLA","7/11/2020","28","8255","6","1773","-22","-6482","-0.785714285","-0.785221078134464","1"
"SLA","8/11/2020","30","8943","1","349","-29","-8594","-0.966666666","-0.9609750642960975","1"
"SLA","9/11/2020","34","10252","4","1047","-30","-9205","-0.882352941","-0.897873585641826","1"
"SLA","10/11/2020","22","6395","3","977","-19","-5418","-0.863636363","-0.8472243940578577","1"
"SLA","11/11/2020","31","9394","12","4190","-19","-5204","-0.612903225","-0.5539706195443901","1"
"SLA","12/11/2020","22","6254","13","4403","-9","-1851","-0.409090909","-0.2959705788295491","1"
"SLA","13/11/2020","13","4035","13","4290","0","255","0","0.06319702602230483","0"
"SLA","14/11/2020","13","3949","11","3469","-2","-480","-0.153846153","-0.12154975943276779","1"
"SLA","15/11/2020","12","3450","8","2302","-4","-1148","-0.333333333","-0.3327536231884058","1"
"SLA","16/11/2020","32","8679","9","2407","-23","-6272","-0.71875","-0.7226639013711257","1"
"SLA","17/11/2020","27","7468","10","2431","-17","-5037","-0.629629629","-0.6744777718264595","1"
"SLA","18/11/2020","10","2486","6","1760","-4","-726","-0.4","-0.2920353982300885","1"
"SLA","19/11/2020","22","2408","8","1682","-14","-726","-0.636363636","-0.3014950166112957","1"
"SLA","20/11/2020","31","7488","11","3454","-20","-4034","-0.64516129","-0.5387286324786325","1"
"SLA","21/11/2020","10","3056","10","2611","0","-445","0","-0.1456151832460733","0"
"SLA","22/11/2020","2","606","2","660","0","54","0","0.0891089108910891","0"
"SLA","23/11/2020","1","-27","1","0","0","27","0","-1","0"
"SLA","24/11/2020","16","4241","8","2293","-8","-1948","-0.5","-0.45932563074746524","1"
"SLA","25/11/2020","14","3291","6","1222","-8","-2069","-0.571428571","-0.628684290489213","1"
"SLA","26/11/2020","19","5089","10","2617","-9","-2472","-0.47368421","-0.4857535861662409","1"
"SLA","27/11/2020","9","2759","9","2676","0","-83","0","-0.03008336353751359","0"
"SLA","28/11/2020","25","8143","14","4048","-11","-4095","-0.44","-0.5028859142822055","1"
"SLA","29/11/2020","19","6199","8","1903","-11","-4296","-0.578947368","-0.6930150024197451","1"
"SLA","30/11/2020","23","6856","12","3359","-11","-3497","-0.478260869","-0.5100641773628938","1"
"SLA","1/12/2020","20","5389","12","3479","-8","-1910","-0.4","-0.3544256819447022","1"
"SLA","2/12/2020","38","9892","9","2972","-29","-6920","-0.763157894","-0.6995551961180753","1"
"SLA","3/12/2020","53","13197","13","3937","-40","-9260","-0.754716981","-0.7016746230203834","1"
"SLA","4/12/2020","38","9453","9","2722","-29","-6731","-0.763157894","-0.7120490849465778","1"
"SLA","5/12/2020","16","4879","15","3658","-1","-1221","-0.0625","-0.250256200040992","0"
"SLA","6/12/2020","22","6842","7","2618","-15","-4224","-0.681818181","-0.617363344051447","1"
"SLA","7/12/2020","14","4333","13","3387","-1","-946","-0.071428571","-0.21832448649896147","0"
"SLA","8/12/2020","8","2455","8","1462","0","-993","0","-0.4044806517311609","0"
"SLA","9/12/2020","17","4081","12","2734","-5","-1347","-0.294117647","-0.3300661602548395","1"
"SLA","10/12/2020","42","8070","10","3985","-32","-4085","-0.761904761","-0.5061957868649318","1"
"SLA","11/12/2020","62","6180","12","4447","-50","-1733","-0.806451612","-0.28042071197411006","1"
"SLA","12/12/2020","9","2716","7","1336","-2","-1380","-0.222222222","-0.508100147275405","1"
"SLA","13/12/2020","6","2216","6","2350","0","134","0","0.06046931407942238","0"
"SLA","14/12/2020","14","859","4","940","-10","81","-0.714285714","0.09429569266589057","1"
"SLA","15/12/2020","6","1495","6","1623","0","128","0","0.08561872909698996","0"
"SLA","16/12/2020","59","0","2","0","-57","0","-0.966101694",,"1"
"SLA","17/12/2020","33","6336","22","4147","-11","-2189","-0.333333333","-0.3454861111111111","1"
"SLA","18/12/2020","27","5985","6","1902","-21","-4083","-0.777777777","-0.6822055137844611","1"
"SLA","19/12/2020","23","7597","23","7827","0","230","0","0.030275108595498222","0"
"SLA","20/12/2020","34","9707","24","5631","-10","-4076","-0.294117647","-0.4199031626661172","1"
"SLA","21/12/2020","18","5753","18","5396","0","-357","0","-0.062054580219016164","0"
"SLA","22/12/2020","13","4208","13","4584","0","376","0","0.08935361216730038","0"
"SLA","23/12/2020","31","9836","20","5928","-11","-3908","-0.354838709","-0.3973159821065474","1"
"SLA","24/12/2020","25","8376","25","6062","0","-2314","0","-0.27626552053486153","0"
"SLA","25/12/2020","12","4467","12","4842","0","375","0","0.08394895903290799","0"
"SLA","26/12/2020","9","2967","9","2553","0","-414","0","-0.13953488372093023","0"
"SLA","27/12/2020","34","8160","29","8490","-5","330","-0.147058823","0.04044117647058824","1"
"SLA","28/12/2020","37","9249","37","8091","0","-1158","0","-0.12520272461887771","0"
"SLA","29/12/2020","19","6321","19","5607","0","-714","0","-0.11295681063122924","0"
"SLA","30/12/2020","21","6650","21","7080","0","430","0","0.06466165413533835","0"
"SLA","31/12/2020","22","7407","22","6875","0","-532","0","-0.07182395031726745","0"
"SLA","1/1/2021","13","4388","14","3826","1","-562","0.076923076","-0.12807657247037374","0"
"SLA","2/1/2021","15","4673","4","1342","-11","-3331","-0.733333333","-0.712818317997004","1"
"SLA","3/1/2021","9","2908","9","3618","0","710","0","0.24415405777166438","0"
"SLA","4/1/2021","7","2877","7","2998","0","121","0","0.04205769899200556","0"
"SLA","5/1/2021","7","2858","7","3005","0","147","0","0.05143456962911127","0"
"SLA","6/1/2021","11","2151","7","2312","-4","161","-0.363636363","0.07484890748489074","1"
"SLA","7/1/2021","36","5550","11","1392","-25","-4158","-0.694444444","-0.7491891891891892","1"
"SLA","8/1/2021","38","5162","2","776","-36","-4386","-0.947368421","-0.8496706702828362","1"
"SLA","9/1/2021","3","1050","3","1103","0","53","0","0.05047619047619047","0"
"SLA","10/1/2021","6","2024","6","2158","0","134","0","0.06620553359683795","0"
"SLA","11/1/2021","8","2958","8","3132","0","174","0","0.058823529411764705","0"
"SLA","12/1/2021","18","5424","7","2488","-11","-2936","-0.611111111","-0.5412979351032449","1"
"SLA","13/1/2021","16","3420","1","350","-15","-3070","-0.9375","-0.8976608187134503","1"
"SLA","14/1/2021","30","3525","10","988","-20","-2537","-0.666666666","-0.7197163120567376","1"
"SLA","15/1/2021","20","322","1","349","-19","27","-0.95","0.08385093167701864","1"
"SLA","16/1/2021","3","1012","3","721","0","-291","0","-0.2875494071146245","0"
"SLA","17/1/2021","4","1257","4","979","0","-278","0","-0.2211614956245028","0"
"SLA","18/1/2021","6","1675","6","1245","0","-430","0","-0.25671641791044775","0"
"SLA","19/1/2021","4","1151","4","1245","0","94","0","0.08166811468288444","0"
"SLA","20/1/2021","7","584","4","638","-3","54","-0.428571428","0.09246575342465753","1"
"SLA","21/1/2021","24","2061","16","1299","-8","-762","-0.333333333","-0.3697234352256186","1"
"SLA","22/1/2021","21","295","2","349","-19","54","-0.904761904","0.18305084745762712","1"
"SLA","23/1/2021","22","5986","5","1707","-17","-4279","-0.772727272","-0.7148346140995656","1"
"SLA","24/1/2021","19","4992","2","633","-17","-4359","-0.894736842","-0.8731971153846154","1"
"SLA","25/1/2021","15","1595","1","305","-14","-1290","-0.933333333","-0.8087774294670846","1"
"SLA","26/1/2021","4","1685","1","395","-3","-1290","-0.75","-0.7655786350148368","1"
"SLA","27/1/2021","6","668","2","721","-4","53","-0.666666666","0.07934131736526946","1"
"SLA","28/1/2021","23","621","2","675","-21","54","-0.913043478","0.08695652173913043","1"
"SLA","29/1/2021","27","0","0","0","-27","0","-1",,"1"
"SLA","30/1/2021","21","0","0","0","-21","0","-1",,"1"
"SLA","31/1/2021","34","4039","1","311","-33","-3728","-0.970588235","-0.9230007427581084","1"
"SLA","1/2/2021","14","4323","2","622","-12","-3701","-0.857142857","-0.8561184362711081","1"
"SLA","2/2/2021","12","284","1","311","-11","27","-0.916666666","0.09507042253521127","1"
"SLA","3/2/2021","25","3160","0","0","-25","-3160","-1","-1","1"
"SLA","4/2/2021","56","4937","7","578","-49","-4359","-0.875","-0.882924853149686","1"
"SLA","5/2/2021","39","5281","3","949","-36","-4332","-0.923076923","-0.8202991857602727","1"
"SLA","6/2/2021","14","3996","3","968","-11","-3028","-0.785714285","-0.7577577577577578","1"
"SLA","7/2/2021","33","3108","0","0","-33","-3108","-1","-1","1"
"SLA","8/2/2021","30","2261","0","0","-30","-2261","-1","-1","1"
"SLA","9/2/2021","19","2261","0","0","-19","-2261","-1","-1","1"
"SLA","10/2/2021","7","901","3","982","-4","81","-0.571428571","0.08990011098779134","1"
"SLA","11/2/2021","20","1148","4","1255","-16","107","-0.8","0.09320557491289198","1"
"SLA","12/2/2021","22","885","3","966","-19","81","-0.863636363","0.09152542372881356","1"
"SLA","13/2/2021","2","562","2","616","0","54","0","0.09608540925266904","0"
"SLA","14/2/2021","2","641","0","0","-2","-641","-1","-1","1"
"SLA","15/2/2021","6","1973","2","372","-4","-1601","-0.666666666","-0.811454637607704","1"
"SLA","16/2/2021","34","7347","3","706","-31","-6641","-0.911764705","-0.9039063563359194","1"
"SLA","17/2/2021","48","10222","2","676","-46","-9546","-0.958333333","-0.9338681275679906","1"
"SLA","18/2/2021","46","1895","2","676","-44","-1219","-0.956521739","-0.6432717678100264","1"
"SLA","19/2/2021","38","298","0","0","-38","-298","-1","-1","1"
"SLA","20/2/2021","21","0","0","0","-21","0","-1",,"1"
"SLA","21/2/2021","39","0","0","0","-39","0","-1",,"1"
"SLA","22/2/2021","8","322","1","349","-7","27","-0.875","0.08385093167701864","1"
"SLA","23/2/2021","2","643","2","683","0","40","0","0.06220839813374806","0"
"SLA","24/2/2021","7","967","3","684","-4","-283","-0.571428571","-0.29265770423991727","1"
"SLA","25/2/2021","39","646","2","350","-37","-296","-0.948717948","-0.4582043343653251","1"
"SLA","26/2/2021","23","1269","4","1026","-19","-243","-0.826086956","-0.19148936170212766","1"
"SLA","27/2/2021","2","622","2","676","0","54","0","0.08681672025723473","0"
"SLA","28/2/2021","0","0","0","0","0","0",,,"0"
"SLA","1/3/2021","1","637","1","664","0","27","0","0.0423861852433281","0"
"SLA","2/3/2021","3","1213","3","1294","0","81","0","0.06677658697444352","0"
"SLA","3/3/2021","6","899","2","953","-4","54","-0.666666666","0.060066740823136816","1"
"SLA","4/3/2021","35","4991","2","632","-33","-4359","-0.942857142","-0.873372069725506","1"
"SLA","5/3/2021","39","5265","3","622","-36","-4643","-0.923076923","-0.8818613485280152","1"
"SLA","6/3/2021","4","1115","4","911","0","-204","0","-0.18295964125560538","0"
"SLA","7/3/2021","2","546","2","600","0","54","0","0.0989010989010989","0"
"SLA","8/3/2021","12","3608","1","289","-11","-3319","-0.916666666","-0.91990022172949","1"
"SLA","9/3/2021","11","3345","0","0","-11","-3345","-1","-1","1"
"SLA","10/3/2021","18","4161","3","883","-15","-3278","-0.833333333","-0.7877913962989666","1"
"SLA","11/3/2021","17","261","2","274","-15","13","-0.882352941","0.04980842911877394","1"
"SLA","12/3/2021","45","7764","1","311","-44","-7453","-0.977777777","-0.9599433281813499","1"
"SLA","13/3/2021","37","7795","1","342","-36","-7453","-0.972972972","-0.9561257216164207","1"
"SLA","14/3/2021","1","284","1","311","0","27","0","0.09507042253521127","0"
"SLA","15/3/2021","2","463","2","517","0","54","0","0.11663066954643629","0"
"SLA","16/3/2021","27","5012","2","653","-25","-4359","-0.925925925","-0.8697126895450917","1"
"SLA","17/3/2021","27","5137","2","791","-25","-4346","-0.925925925","-0.8460190772824606","1"
"SLA","18/3/2021","24","0","0","0","-24","0","-1",,"1"
"SLA","19/3/2021","25","746","3","813","-22","67","-0.88","0.08981233243967829","1"
"SLA","20/3/2021","26","322","1","349","-25","27","-0.961538461","0.08385093167701864","1"
"SLA","21/3/2021","22","322","1","349","-21","27","-0.954545454","0.08385093167701864","1"
"SLA","22/3/2021","3","1053","3","1147","0","94","0","0.0892687559354226","0"
"SLA","23/3/2021","10","644","2","698","-8","54","-0.8","0.08385093167701864","1"
"SLA","24/3/2021","26","4016","13","4041","-13","25","-0.5","0.006225099601593625","1"
"SLA","25/3/2021","56","3126","10","3070","-46","-56","-0.821428571","-0.017914267434420986","1"
"SLA","26/3/2021","22","2116","6","2264","-16","148","-0.727272727","0.06994328922495274","1"
"SLA","27/3/2021","17","4844","7","2166","-10","-2678","-0.588235294","-0.5528488852188275","1"
"SLA","28/3/2021","63","19013","2","566","-61","-18447","-0.968253968","-0.9702308946510283","1"
"SLA","29/3/2021","14","4026","5","1590","-9","-2436","-0.642857142","-0.6050670640834576","1"
"SLA","30/3/2021","0","0","0","0","0","0",,,"0"
"SLA","31/3/2021","1","283","0","0","-1","-283","-1","-1","1"
"SLA","1/4/2021","11","1386","10","889","-1","-497","-0.09090909","-0.35858585858585856","0"
"SLA","2/4/2021","62","641","2","334","-60","-307","-0.967741935","-0.4789391575663027","1"
"SLA","3/4/2021","68","2178","8","617","-60","-1561","-0.882352941","-0.716712580348944","1"
"SLA","4/4/2021","15","3999","15","2231","0","-1768","0","-0.442110527631908","0"
"SLA","5/4/2021","16","3789","16","1912","0","-1877","0","-0.49538136711533387","0"
"SLA","6/4/2021","11","651","3","244","-8","-407","-0.727272727","-0.6251920122887865","1"
"SLA","7/4/2021","11","651","3","244","-8","-407","-0.727272727","-0.6251920122887865","1"
"SLA","8/4/2021","10","193","1","220","-9","27","-0.9","0.13989637305699482","1"
"SLA","9/4/2021","3","575","3","642","0","67","0","0.11652173913043479","0"
"SLA","10/4/2021","1","0","0","0","-1","0","-1",,"1"
"SLA","11/4/2021","9","914","4","496","-5","-418","-0.555555555","-0.4573304157549234","1"
"SLA","12/4/2021","19","687","3","256","-16","-431","-0.842105263","-0.6273653566229985","1"
"SLA","13/4/2021","24","0","0","0","-24","0","-1",,"1"
"SLA","14/4/2021","8","0","0","0","-8","0","-1",,"1"
"SLA","15/4/2021","14","0","0","0","-14","0","-1",,"1"
"SLA","16/4/2021","8","0","0","0","-8","0","-1",,"1"
"SLA","17/4/2021","25","0","4","0","-21","0","-0.84",,"1"
"SLA","18/4/2021","21","0","0","0","-21","0","-1",,"1"
"SLA","19/4/2021","1","256","1","256","0","0","0","0","0"
"SLA","20/4/2021","1","189","1","216","0","27","0","0.14285714285714285","0"
"SLA","21/4/2021","1","189","1","216","0","27","0","0.14285714285714285","0"
"SLA","22/4/2021","22","189","1","216","-21","27","-0.954545454","0.14285714285714285","1"
"SLA","23/4/2021","4","0","0","0","-4","0","-1",,"1"
"SLA","24/4/2021","5","0","0","0","-5","0","-1",,"1"
"SLA","25/4/2021","7","0","0","0","-7","0","-1",,"1"
"SLA","26/4/2021","56","0","0","0","-56","0","-1",,"1"
"SLA","27/4/2021","56","0","0","0","-56","0","-1",,"1"
"SLA","28/4/2021","58","431","2","229","-56","-202","-0.965517241","-0.46867749419953597","1"
"SLA","29/4/2021","57","334","1","334","-56","0","-0.98245614","0","1"
"SLA","30/4/2021","6","334","1","334","-5","0","-0.833333333","0","1"
"SLA","1/5/2021","0","0","0","0","0","0",,,"0"
"SLA","2/5/2021","0","0","0","0","0","0",,,"0"
"SLA","3/5/2021","1","262","1","289","0","27","0","0.10305343511450382","0"
"SLA","4/5/2021","0","0","0","0","0","0",,,"0"
"SLA","5/5/2021","0","0","0","0","0","0",,,"0"
"SLA","6/5/2021","1","295","1","335","0","40","0","0.13559322033898305","0"
"SLA","7/5/2021","1","295","1","335","0","40","0","0.13559322033898305","0"
"SLA","8/5/2021","1","256","1","256","0","0","0","0","0"
"SLA","9/5/2021","0","0","0","0","0","0",,,"0"
"SLA","10/5/2021","0","0","0","0","0","0",,,"0"
"SLA","11/5/2021","0","0","0","0","0","0",,,"0"
"SLA","12/5/2021","1","336","1","336","0","0","0","0","0"
"SLA","13/5/2021","1","336","1","336","0","0","0","0","0"
"SLA","14/5/2021","1","336","1","336","0","0","0","0","0"
"SLA","15/5/2021","0","0","0","0","0","0",,,"0"
"SLA","16/5/2021","0","0","0","0","0","0",,,"0"
"SLA","17/5/2021","0","0","0","0","0","0",,,"0"
"SLA","18/5/2021","0","0","0","0","0","0",,,"0"
"SLA","19/5/2021","0","0","0","0","0","0",,,"0"
"SLA","20/5/2021","0","0","0","0","0","0",,,"0"
"SLA","21/5/2021","0","0","0","0","0","0",,,"0"
"SLA","22/5/2021","0","0","0","0","0","0",,,"0"
"SLA","23/5/2021","0","0","0","0","0","0",,,"0"
"SLA","24/5/2021","0","0","0","0","0","0",,,"0"
"SLA","25/5/2021","0","0","0","0","0","0",,,"0"
"SLA","26/5/2021","0","0","0","0","0","0",,,"0"
"SLA","27/5/2021","0","0","0","0","0","0",,,"0"
"SLA","28/5/2021","2","512","2","256","0","-256","0","-0.5","0"
"SLA","29/5/2021","2","512","2","256","0","-256","0","-0.5","0"
"SLA","30/5/2021","0","0","0","0","0","0",,,"0"
"SLA","31/5/2021","0","0","0","0","0","0",,,"0"
"SLA","1/6/2021","0","0","0","0","0","0",,,"0"
"SLA","2/6/2021","0","0","0","0","0","0",,,"0"
"SLA","3/6/2021","0","0","0","0","0","0",,,"0"
"SLA","4/6/2021","0","0","0","0","0","0",,,"0"
"SLA","5/6/2021","0","0","0","0","0","0",,,"0"
"SLA","6/6/2021","0","0","0","0","0","0",,,"0"
"SLA","7/6/2021","0","0","0","0","0","0",,,"0"
"SLA","8/6/2021","0","0","0","0","0","0",,,"0"
"SLA","9/6/2021","0","0","0","0","0","0",,,"0"
"SLA","10/6/2021","1","206","1","206","0","0","0","0","0"
"SLA","11/6/2021","1","206","1","206","0","0","0","0","0"
"SLA","12/6/2021","2","412","2","412","0","0","0","0","0"
"SLA","13/6/2021","5","0","0","0","-5","0","-1",,"1"
"SLA","14/6/2021","18","851","2","851","-16","0","-0.888888888","0","1"
"SLA","15/6/2021","16","0","0","0","-16","0","-1",,"1"
"SLA","16/6/2021","0","0","0","0","0","0",,,"0"
"SLA","17/6/2021","0","0","0","0","0","0",,,"0"
"SLA","18/6/2021","0","0","0","0","0","0",,,"0"
"SLA","19/6/2021","0","0","0","0","0","0",,,"0"
"SLA","20/6/2021","0","0","0","0","0","0",,,"0"
"SLA","21/6/2021","0","0","0","0","0","0",,,"0"
"SLA","22/6/2021","0","0","0","0","0","0",,,"0"
"SLA","23/6/2021","0","0","0","0","0","0",,,"0"
"SLA","24/6/2021","0","0","0","0","0","0",,,"0"
"SLA","25/6/2021","0","0","0","0","0","0",,,"0"
"SLA","26/6/2021","0","0","0","0","0","0",,,"0"
"SLA","27/6/2021","0","0","0","0","0","0",,,"0"
"SLA","28/6/2021","0","0","0","0","0","0",,,"0"
"SLA","29/6/2021","0","0","0","0","0","0",,,"0"
"SLA","30/6/2021","5","0","0","0","-5","0","-1",,"1"
"SLA","1/7/2021","16","0","0","0","-16","0","-1",,"1"
"SLA","2/7/2021","19","656","3","450","-16","-206","-0.842105263","-0.31402439024390244","1"
"SLA","3/7/2021","0","0","0","0","0","0",,,"0"
"SLA","4/7/2021","0","0","0","0","0","0",,,"0"
"SLA","5/7/2021","0","0","0","0","0","0",,,"0"
"SLA","6/7/2021","1","184","1","184","0","0","0","0","0"
"SLA","7/7/2021","1","184","1","184","0","0","0","0","0"
"SLA","8/7/2021","0","0","0","0","0","0",,,"0"
"SLA","9/7/2021","0","0","0","0","0","0",,,"0"
"SLA","10/7/2021","0","0","0","0","0","0",,,"0"
"SLA","11/7/2021","5","0","0","0","-5","0","-1",,"1"
"SLA","12/7/2021","16","0","0","0","-16","0","-1",,"1"
"SLA","13/7/2021","16","0","0","0","-16","0","-1",,"1"
"SLA","14/7/2021","3","694","3","694","0","0","0","0","0"
"SLA","15/7/2021","3","694","3","694","0","0","0","0","0"
"SLA","16/7/2021","3","694","3","694","0","0","0","0","0"
"SLA","17/7/2021","0","0","0","0","0","0",,,"0"
"SLA","18/7/2021","0","0","0","0","0","0",,,"0"
"SLA","19/7/2021","0","0","0","0","0","0",,,"0"
"SLA","20/7/2021","0","0","0","0","0","0",,,"0"
"SLA","21/7/2021","0","0","0","0","0","0",,,"0"
"SLA","22/7/2021","0","0","0","0","0","0",,,"0"
"SLA","23/7/2021","0","0","0","0","0","0",,,"0"
"SLA","24/7/2021","0","0","0","0","0","0",,,"0"
"SLA","25/7/2021","0","0","0","0","0","0",,,"0"
"SLA","26/7/2021","0","0","0","0","0","0",,,"0"
"SLA","27/7/2021","0","0","0","0","0","0",,,"0"
"SLA","28/7/2021","0","0","0","0","0","0",,,"0"
"SLA","29/7/2021","0","0","0","0","0","0",,,"0"
"SLA","30/7/2021","0","0","0","0","0","0",,,"0"
"SLA","31/7/2021","0","0","0","0","0","0",,,"0"
"SLA","1/8/2021","0","0","0","0","0","0",,,"0"
"SLA","2/8/2021","0","0","0","0","0","0",,,"0"
"SLA","3/8/2021","0","0","0","0","0","0",,,"0"
"SLA","4/8/2021","1","229","1","229","0","0","0","0","0"
"SLA","5/8/2021","1","229","1","229","0","0","0","0","0"
"SLA","6/8/2021","1","229","1","229","0","0","0","0","0"
"SLA","7/8/2021","0","0","0","0","0","0",,,"0"
"SLA","8/8/2021","0","0","0","0","0","0",,,"0"
"SLA","9/8/2021","0","0","0","0","0","0",,,"0"
"SLA","10/8/2021","0","0","0","0","0","0",,,"0"
"SLA","11/8/2021","0","0","0","0","0","0",,,"0"
"SLA","12/8/2021","0","0","0","0","0","0",,,"0"
"SLA","13/8/2021","0","0","0","0","0","0",,,"0"
"SLA","14/8/2021","0","0","0","0","0","0",,,"0"
"SLA","15/8/2021","0","0","0","0","0","0",,,"0"
"SLA","16/8/2021","0","0","0","0","0","0",,,"0"
"SLA","17/8/2021","0","0","0","0","0","0",,,"0"
"SLA","18/8/2021","0","0","0","0","0","0",,,"0"
"SLA","19/8/2021","0","0","0","0","0","0",,,"0"
"SLA","20/8/2021","0","0","0","0","0","0",,,"0"
"SLA","21/8/2021","0","0","0","0","0","0",,,"0"
"SLA","22/8/2021","0","0","0","0","0","0",,,"0"
"SLA","23/8/2021","0","0","0","0","0","0",,,"0"
"SLA","24/8/2021","0","0","0","0","0","0",,,"0"
"SLA","25/8/2021","0","0","0","0","0","0",,,"0"
"SLA","26/8/2021","0","0","0","0","0","0",,,"0"
"SLA","27/8/2021","0","0","0","0","0","0",,,"0"
"SLA","28/8/2021","0","0","0","0","0","0",,,"0"
"SLA","29/8/2021","0","0","0","0","0","0",,,"0"
"SLA","30/8/2021","0","0","0","0","0","0",,,"0"
"SLA","31/8/2021","0","0","0","0","0","0",,,"0"
"SLA","1/9/2021","5","0","0","0","-5","0","-1",,"1"
"SLA","2/9/2021","16","0","0","0","-16","0","-1",,"1"
"SLA","3/9/2021","16","0","0","0","-16","0","-1",,"1"
"SLA","4/9/2021","0","0","0","0","0","0",,,"0"
"SLA","5/9/2021","1","206","1","206","0","0","0","0","0"
"SLA","6/9/2021","0","0","0","0","0","0",,,"0"
"SLA","7/9/2021","0","0","0","0","0","0",,,"0"
"SLA","8/9/2021","0","0","0","0","0","0",,,"0"
"SLA","9/9/2021","0","0","0","0","0","0",,,"0"
"SLA","10/9/2021","0","0","0","0","0","0",,,"0"
"SLA","11/9/2021","0","0","0","0","0","0",,,"0"
"SLA","12/9/2021","0","0","0","0","0","0",,,"0"
"SLA","13/9/2021","1","221","1","221","0","0","0","0","0"
"SLA","14/9/2021","2","414","2","414","0","0","0","0","0"
"SLA","15/9/2021","1","193","1","193","0","0","0","0","0"
"SLA","16/9/2021","1","193","1","193","0","0","0","0","0"
"SLA","17/9/2021","0","0","0","0","0","0",,,"0"
"SLA","18/9/2021","0","0","0","0","0","0",,,"0"
"SLA","19/9/2021","0","0","0","0","0","0",,,"0"
"SLA","20/9/2021","0","0","0","0","0","0",,,"0"
"SLA","21/9/2021","0","0","0","0","0","0",,,"0"
"SLA","22/9/2021","0","0","0","0","0","0",,,"0"
"SLA","23/9/2021","5","0","0","0","-5","0","-1",,"1"
"SLA","24/9/2021","8","0","0","0","-8","0","-1",,"1"
"SLA","25/9/2021","22","244","1","244","-21","0","-0.954545454","0","1"
"SLA","26/9/2021","22","244","1","244","-21","0","-0.954545454","0","1"
"SLA","27/9/2021","1","244","1","244","0","0","0","0","0"
"SLA","28/9/2021","0","0","0","0","0","0",,,"0"
"SLA","29/9/2021","0","0","0","0","0","0",,,"0"
"SLA","30/9/2021","21","0","0","0","-21","0","-1",,"1"
"SLA","1/10/2021","0","0","0","0","0","0",,,"0"
"SLA","2/10/2021","0","0","0","0","0","0",,,"0"
"SLA","3/10/2021","0","0","0","0","0","0",,,"0"
"SLA","4/10/2021","1","244","1","244","0","0","0","0","0"
"SLA","5/10/2021","1","244","1","244","0","0","0","0","0"
"SLA","6/10/2021","1","244","1","244","0","0","0","0","0"
"SLA","7/10/2021","22","1520","6","496","-16","-1024","-0.727272727","-0.6736842105263158","1"
"SLA","8/10/2021","19","0","0","0","-19","0","-1",,"1"
"SLA","9/10/2021","32","0","0","0","-32","0","-1",,"1"
"SLA","10/10/2021","21","0","0","0","-21","0","-1",,"1"
"SLA","11/10/2021","0","0","0","0","0","0",,,"0"
"SLA","12/10/2021","0","0","0","0","0","0",,,"0"
"SLA","13/10/2021","8","0","0","0","-8","0","-1",,"1"
"SLA","14/10/2021","56","0","2","0","-54","0","-0.964285714",,"1"
"SLA","15/10/2021","37","0","0","0","-37","0","-1",,"1"
"SLA","16/10/2021","21","0","0","0","-21","0","-1",,"1"
"SLA","17/10/2021","21","0","0","0","-21","0","-1",,"1"
"SLA","18/10/2021","0","0","0","0","0","0",,,"0"
"SLA","19/10/2021","8","0","0","0","-8","0","-1",,"1"
"SLA","20/10/2021","8","0","0","0","-8","0","-1",,"1"
"SLA","21/10/2021","35","0","0","0","-35","0","-1",,"1"
"SLA","22/10/2021","8","0","0","0","-8","0","-1",,"1"
"SLA","23/10/2021","21","0","0","0","-21","0","-1",,"1"
"SLA","24/10/2021","21","0","0","0","-21","0","-1",,"1"
"SLA","25/10/2021","0","0","0","0","0","0",,,"0"
"SLA","26/10/2021","0","0","0","0","0","0",,,"0"
"SLA","27/10/2021","4","0","0","0","-4","0","-1",,"1"
"SLA","28/10/2021","40","0","0","0","-40","0","-1",,"1"
"SLA","29/10/2021","29","0","0","0","-29","0","-1",,"1"
"SLA","30/10/2021","0","0","0","0","0","0",,,"0"
"SLA","31/10/2021","14","0","0","0","-14","0","-1",,"1"
"SLA","1/11/2021","14","0","0","0","-14","0","-1",,"1"
"SLA","2/11/2021","8","0","0","0","-8","0","-1",,"1"
"SLA","3/11/2021","8","0","0","0","-8","0","-1",,"1"
"SLA","4/11/2021","14","0","0","0","-14","0","-1",,"1"
"SLA","5/11/2021","8","0","0","0","-8","0","-1",,"1"
"SLA","6/11/2021","21","0","0","0","-21","0","-1",,"1"
"SLA","7/11/2021","28","0","0","0","-28","0","-1",,"1"
"SLA","8/11/2021","7","0","0","0","-7","0","-1",,"1"
"SLA","9/11/2021","8","0","0","0","-8","0","-1",,"1"
"SLA","10/11/2021","8","0","0","0","-8","0","-1",,"1"
"SLA","11/11/2021","30","0","0","0","-30","0","-1",,"1"
"SLA","12/11/2021","0","0","0","0","0","0",,,"0"
"SLA","13/11/2021","0","0","0","0","0","0",,,"0"
"SLA","14/11/2021","0","0","0","0","0","0",,,"0"
"SLA","15/11/2021","0","0","0","0","0","0",,,"0"
"SLA","16/11/2021","0","0","0","0","0","0",,,"0"
"SLA","17/11/2021","4","0","0","0","-4","0","-1",,"1"
"SLA","18/11/2021","21","0","1","0","-20","0","-0.952380952",,"1"
"SLA","19/11/2021","27","0","0","0","-27","0","-1",,"1"
"SLA","20/11/2021","22","349","1","349","-21","0","-0.954545454","0","1"
"SLA","21/11/2021","22","349","1","349","-21","0","-0.954545454","0","1"
"SLA","22/11/2021","0","0","0","0","0","0",,,"0"
"SLA","23/11/2021","8","0","0","0","-8","0","-1",,"1"
"SLA","24/11/2021","8","0","0","0","-8","0","-1",,"1"
"SLA","25/11/2021","61","0","0","0","-61","0","-1",,"1"
"SLA","26/11/2021","0","0","0","0","0","0",,,"0"
"SLA","27/11/2021","0","0","0","0","0","0",,,"0"
"SLA","28/11/2021","18","0","0","0","-18","0","-1",,"1"
"SLA","29/11/2021","18","0","0","0","-18","0","-1",,"1"
"SLA","30/11/2021","12","0","0","0","-12","0","-1",,"1"
"SLA","1/12/2021","16","0","0","0","-16","0","-1",,"1"
"SLA","2/12/2021","26","350","1","350","-25","0","-0.961538461","0","1"
"SLA","3/12/2021","19","0","0","0","-19","0","-1",,"1"
"SLA","4/12/2021","0","0","0","0","0","0",,,"0"
"SLA","5/12/2021","0","0","0","0","0","0",,,"0"
"SLA","6/12/2021","0","0","0","0","0","0",,,"0"
"SLA","7/12/2021","0","0","0","0","0","0",,,"0"
"SLA","8/12/2021","0","0","0","0","0","0",,,"0"
"SLA","9/12/2021","5","0","0","0","-5","0","-1",,"1"
"SLA","10/12/2021","8","0","0","0","-8","0","-1",,"1"
"SLA","11/12/2021","46","0","0","0","-46","0","-1",,"1"
"SLA","12/12/2021","28","0","0","0","-28","0","-1",,"1"
"SLA","13/12/2021","1","727","1","727","0","0","0","0","0"
"SLA","14/12/2021","0","0","0","0","0","0",,,"0"
"SLA","15/12/2021","4","0","0","0","-4","0","-1",,"1"
"SLA","16/12/2021","38","326","1","326","-37","0","-0.97368421","0","1"
"SLA","17/12/2021","20","326","1","326","-19","0","-0.95","0","1"
"SLA","18/12/2021","3","1004","3","677","0","-327","0","-0.3256972111553785","0"
"SLA","19/12/2021","2","654","2","327","0","-327","0","-0.5","0"
"SLA","20/12/2021","0","0","0","0","0","0",,,"0"
"SLA","21/12/2021","0","0","0","0","0","0",,,"0"
"SLA","22/12/2021","0","0","0","0","0","0",,,"0"
"SLA","23/12/2021","2","622","2","311","0","-311","0","-0.5","0"
"SLA","24/12/2021","7","0","0","0","-7","0","-1",,"1"
"SLA","25/12/2021","0","0","0","0","0","0",,,"0"
"SLA","26/12/2021","0","0","0","0","0","0",,,"0"
"SLA","27/12/2021","3","980","3","669","0","-311","0","-0.3173469387755102","0"
"SLA","28/12/2021","0","0","0","0","0","0",,,"0"
"SLA","29/12/2021","0","0","0","0","0","0",,,"0"
"SLA","30/12/2021","0","0","0","0","0","0",,,"0"
"SLA","31/12/2021","0","0","0","0","0","0",,,"0"
"SPA","1/1/2018","54","28561","0","0","-54","-28561","-1","-1","1"
"SPA","2/1/2018","46","25335","0","0","-46","-25335","-1","-1","1"
"SPA","3/1/2018","52","32222","0","0","-52","-32222","-1","-1","1"
"SPA","4/1/2018","55","16998","0","0","-55","-16998","-1","-1","1"
"SPA","5/1/2018","55","24099","1","50000","-54","25901","-0.981818181","1.0747748869247686","1"
"SPA","6/1/2018","53","26327","1","744","-52","-25583","-0.981132075","-0.9717400387434952","1"
"SPA","7/1/2018","43","10192","1","744","-42","-9448","-0.976744186","-0.9270015698587127","1"
"SPA","8/1/2018","50","23069","1","257550","-49","234481","-0.98","10.164333087693441","1"
"SPA","9/1/2018","43","21240","0","0","-43","-21240","-1","-1","1"
"SPA","10/1/2018","52","25856","2","2397","-50","-23459","-0.961538461","-0.907294245049505","1"
"SPA","11/1/2018","53","25323","3","3538","-50","-21785","-0.943396226","-0.8602851162974371","1"
"SPA","12/1/2018","47","18874","3","219437","-44","200563","-0.936170212","10.62641729363145","1"
"SPA","13/1/2018","57","17914","3","219437","-54","201523","-0.947368421","11.249469688511779","1"
"SPA","14/1/2018","54","14151","0","0","-54","-14151","-1","-1","1"
"SPA","15/1/2018","51","15701","2","1060","-49","-14641","-0.960784313","-0.9324883765365264","1"
"SPA","16/1/2018","49","15065","3","51060","-46","35995","-0.93877551","2.3893129770992365","1"
"SPA","17/1/2018","31","14794","0","0","-31","-14794","-1","-1","1"
"SPA","18/1/2018","35","15817","3","1007","-32","-14810","-0.914285714","-0.9363343238287918","1"
"SPA","19/1/2018","35","16814","3","1453","-32","-15361","-0.914285714","-0.9135839181634352","1"
"SPA","20/1/2018","56","22268","2","965","-54","-21303","-0.964285714","-0.9566642716005029","1"
"SPA","21/1/2018","52","21271","5","2406","-47","-18865","-0.903846153","-0.8868882516101735","1"
"SPA","22/1/2018","50","18142","4","166989","-46","148847","-0.92","8.204552971006505","1"
"SPA","23/1/2018","51","18140","4","359762","-47","341622","-0.921568627","18.83252480705623","1"
"SPA","24/1/2018","57","25525","13","1838379","-44","1812854","-0.771929824","71.02268364348677","1"
"SPA","25/1/2018","45","20506","8","361335","-37","340829","-0.822222222","16.620940212620695","1"
"SPA","26/1/2018","55","22593","5","2584","-50","-20009","-0.909090909","-0.8856282919488337","1"
"SPA","27/1/2018","54","21449","21","11342","-33","-10107","-0.611111111","-0.4712107790572987","1"
"SPA","28/1/2018","46","17975","21","589340","-25","571365","-0.54347826","31.78664812239221","1"
"SPA","29/1/2018","51","18695","21","589340","-30","570645","-0.588235294","30.523936881519123","1"
"SPA","30/1/2018","51","22396","21","11355","-30","-11041","-0.588235294","-0.49298981961064475","1"
"SPA","31/1/2018","32","15008","2","1060","-30","-13948","-0.9375","-0.9293710021321961","1"
"SPA","1/2/2018","34","16610","4","395856","-30","379246","-0.882352941","22.83239012642986","1"
"SPA","2/2/2018","36","17399","5","396486","-31","379087","-0.861111111","21.78786137134318","1"
"SPA","3/2/2018","53","19666","3","395326","-50","375660","-0.943396226","19.10200345774433","1"
"SPA","4/2/2018","49","18898","7","3172","-42","-15726","-0.857142857","-0.8321515504286168","1"
"SPA","5/2/2018","48","18971","6","2436","-42","-16535","-0.875","-0.8715934847925781","1"
"SPA","6/2/2018","55","24050","4","1793","-51","-22257","-0.927272727","-0.9254469854469854","1"
"SPA","7/2/2018","41","18861","7","3104","-34","-15757","-0.829268292","-0.8354276019299083","1"
"SPA","8/2/2018","52","22977","3","1389","-49","-21588","-0.942307692","-0.93954824389607","1"
"SPA","9/2/2018","52","22544","4","669183","-48","646639","-0.923076923","28.683419091554295","1"
"SPA","10/2/2018","54","18383","23","1346982","-31","1328599","-0.574074074","72.27324158189631","1"
"SPA","11/2/2018","53","22689","27","1349952","-26","1327263","-0.490566037","58.49808277138702","1"
"SPA","12/2/2018","54","22960","28","684264","-26","661304","-0.481481481","28.802439024390242","1"
"SPA","13/2/2018","50","21003","32","19973","-18","-1030","-0.36","-0.049040613245726804","1"
"SPA","14/2/2018","42","22368","15","677460","-27","655092","-0.642857142","29.287017167381975","1"
"SPA","15/2/2018","35","19404","14","3345256","-21","3325852","-0.6","171.40032982890125","1"
"SPA","16/2/2018","50","25575","15","4013277","-35","3987702","-0.7","155.9218768328446","1"
"SPA","17/2/2018","49","24956","12","3343503","-37","3318547","-0.75510204","132.9759176150024","1"
"SPA","18/2/2018","45","24799","6","672550","-39","647751","-0.866666666","26.120045163111417","1"
"SPA","19/2/2018","53","24429","34","18622","-19","-5807","-0.358490566","-0.23770927995415286","1"
"SPA","20/2/2018","35","16216","7","870847","-28","854631","-0.8","52.702947705969414","1"
"SPA","21/2/2018","39","19244","16","874045","-23","854801","-0.589743589","44.41909166493453","1"
"SPA","22/2/2018","53","26362","22","2219185","-31","2192823","-0.58490566","83.18120779910477","1"
"SPA","23/2/2018","41","20795","23","2219404","-18","2198609","-0.43902439","105.72777109882183","1"
"SPA","24/2/2018","56","24303","36","1821278","-20","1796975","-0.357142857","73.94046002551126","1"
"SPA","25/2/2018","51","21384","28","1295260","-23","1273876","-0.450980392","59.571455293677516","1"
"SPA","26/2/2018","53","21367","31","835698","-22","814331","-0.415094339","38.111620723545656","1"
"SPA","27/2/2018","47","16331","30","884140","-17","867809","-0.361702127","53.138754515951256","1"
"SPA","28/2/2018","25","12045","11","657499","-14","645454","-0.56","53.58688252386882","1"
"SPA","1/3/2018","40","17606","21","308616","-19","291010","-0.475","16.529024196296717","1"
"SPA","2/3/2018","47","21718","21","260101","-26","238383","-0.553191489","10.976286950916291","1"
"SPA","3/3/2018","47","19119","21","14599","-26","-4520","-0.553191489","-0.23641403839112923","1"
"SPA","4/3/2018","23","8752","11","106069","-12","97317","-0.52173913","11.119401279707496","1"
"SPA","5/3/2018","28","11660","11","299871","-17","288211","-0.607142857","24.717924528301886","1"
"SPA","6/3/2018","46","17797","18","1406593","-28","1388796","-0.608695652","78.03539922458842","1"
"SPA","7/3/2018","47","22163","17","1695028","-30","1672865","-0.638297872","75.480079411632","1"
"SPA","8/3/2018","50","31008","22","1504057","-28","1473049","-0.56","47.50545020639835","1"
"SPA","9/3/2018","52","24200","25","1693939","-27","1669739","-0.519230769","68.99747933884298","1"
"SPA","10/3/2018","53","19262","35","332817","-18","313555","-0.339622641","16.278423839684354","1"
"SPA","11/3/2018","50","19726","33","787901","-17","768175","-0.34","38.94225894758187","1"
"SPA","12/3/2018","48","18424","31","886491","-17","868067","-0.354166666","47.11609856708641","1"
"SPA","13/3/2018","53","21745","22","679944","-31","658199","-0.58490566","30.26898137502874","1"
"SPA","14/3/2018","43","22329","4","51473","-39","29144","-0.906976744","1.3052084732858615","1"
"SPA","15/3/2018","52","25746","4","3272","-48","-22474","-0.923076923","-0.8729122970558534","1"
"SPA","16/3/2018","56","17770","17","448953","-39","431183","-0.696428571","24.264659538548116","1"
"SPA","17/3/2018","51","15716","17","622389","-34","606673","-0.666666666","38.60225248154747","1"
"SPA","18/3/2018","44","13132","20","623789","-24","610657","-0.545454545","46.50144684739568","1"
"SPA","19/3/2018","54","12855","49","544337","-5","531482","-0.092592592","41.34437961882536","0"
"SPA","20/3/2018","20","7171","15","794017","-5","786846","-0.25","109.72611909078232","1"
"SPA","21/3/2018","24","9501","15","598316","-9","588815","-0.375","61.97400273655405","1"
"SPA","22/3/2018","38","15790","28","2982055","-10","2966265","-0.263157894","187.8571880937302","1"
"SPA","23/3/2018","54","18908","37","3072953","-17","3054045","-0.314814814","161.52131372963825","1"
"SPA","24/3/2018","56","20326","31","2598836","-25","2578510","-0.446428571","126.85771917740824","1"
"SPA","25/3/2018","53","14283","24","657408","-29","643125","-0.547169811","45.02730518798572","1"
"SPA","26/3/2018","46","21367","21","406130","-25","384763","-0.54347826","18.007347779285816","1"
"SPA","27/3/2018","42","21934","16","181201","-26","159267","-0.619047619","7.261192668915839","1"
"SPA","28/3/2018","42","17945","13","179262","-29","161317","-0.69047619","8.989523544162719","1"
"SPA","29/3/2018","56","23036","23","205378","-33","182342","-0.589285714","7.915523528390345","1"
"SPA","30/3/2018","57","17593","27","332419","-30","314826","-0.526315789","17.894958222020122","1"
"SPA","31/3/2018","52","14045","30","1764059","-22","1750014","-0.423076923","124.60049839800641","1"
"SPA","1/4/2018","30","9526","23","1150244","-7","1140718","-0.233333333","119.74784799496116","1"
"SPA","2/4/2018","25","7036","23","421886","-2","414850","-0.08","58.96105741898806","0"
"SPA","3/4/2018","57","11599","57","11854","0","255","0","0.021984653849469783","0"
"SPA","4/4/2018","57","10800","57","11854","0","1054","0","0.09759259259259259","0"
"SPA","5/4/2018","57","11838","57","11854","0","16","0","0.0013515796587261362","0"
"SPA","6/4/2018","57","7651","57","11854","0","4203","0","0.5493399555613645","0"
"SPA","7/4/2018","17","5996","16","590236","-1","584240","-0.058823529","97.43829219479653","0"
"SPA","8/4/2018","16","6448","13","1790539","-3","1784091","-0.1875","276.68905086848633","1"
"SPA","9/4/2018","19","4069","14","493573","-5","489504","-0.263157894","120.30081101007619","1"
"SPA","10/4/2018","25","7860","15","885375","-10","877515","-0.4","111.64312977099236","1"
"SPA","11/4/2018","20","5104","15","1025198","-5","1020094","-0.25","199.86167711598745","1"
"SPA","12/4/2018","22","6525","18","2181626","-4","2175101","-0.181818181","333.3488122605364","1"
"SPA","13/4/2018","30","7522","21","2750019","-9","2742497","-0.3","364.59678277053973","1"
"SPA","14/4/2018","29","6059","22","3078807","-7","3072748","-0.24137931","507.1378115200528","1"
"SPA","15/4/2018","6","2145","4","406056","-2","403911","-0.333333333","188.3034965034965","1"
"SPA","16/4/2018","11","762","10","298","-1","-464","-0.09090909","-0.6089238845144357","0"
"SPA","17/4/2018","19","2506","19","2957","0","451","0","0.1799680766161213","0"
"SPA","18/4/2018","15","3191","15","3717","0","526","0","0.16483860858664995","0"
"SPA","19/4/2018","38","6779","34","775081","-4","768302","-0.105263157","113.335595220534","1"
"SPA","20/4/2018","29","7668","18","586193","-11","578525","-0.379310344","75.44666145018257","1"
"SPA","21/4/2018","28","9186","17","440138","-11","430952","-0.392857142","46.91399956455476","1"
"SPA","22/4/2018","18","6272","16","407826","-2","401554","-0.111111111","64.02327806122449","1"
"SPA","23/4/2018","17","2590","15","531226","-2","528636","-0.117647058","204.10656370656372","1"
"SPA","24/4/2018","14","4599","13","528807","-1","524208","-0.071428571","113.98303979125897","0"
"SPA","25/4/2018","10","4837","9","407973","-1","403136","-0.1","83.34422162497415","1"
"SPA","26/4/2018","17","1676","16","766812","-1","765136","-0.058823529","456.52505966587114","0"
"SPA","27/4/2018","36","6484","35","1387969","-1","1381485","-0.027777777","213.06061073411473","0"
"SPA","28/4/2018","46","11009","43","3848366","-3","3837357","-0.065217391","348.56544645290217","0"
"SPA","29/4/2018","44","8725","41","3562341","-3","3553616","-0.068181818","407.2912320916905","0"
"SPA","30/4/2018","37","8738","34","3763065","-3","3754327","-0.081081081","429.6551842526894","0"
"SPA","1/5/2018","2","1232","2","723","0","-509","0","-0.41314935064935066","0"
"SPA","2/5/2018","0","12","0","0","0","-12",,"-1","0"
"SPA","3/5/2018","0","0","0","0","0","0",,,"0"
"SPA","4/5/2018","0","-1257","0","0","0","1257",,"-1","0"
"SPA","5/5/2018","0","0","0","0","0","0",,,"0"
"SPA","6/5/2018","0","0","0","0","0","0",,,"0"
"SPA","7/5/2018","0","0","0","0","0","0",,,"0"
"SPA","8/5/2018","0","-861","0","0","0","861",,"-1","0"
"SPA","9/5/2018","0","-29","0","0","0","29",,"-1","0"
"SPA","10/5/2018","0","-62","0","0","0","62",,"-1","0"
"SPA","11/5/2018","0","0","0","0","0","0",,,"0"
"SPA","12/5/2018","0","0","0","0","0","0",,,"0"
"SPA","13/5/2018","0","0","0","0","0","0",,,"0"
"SPA","14/5/2018","0","0","0","0","0","0",,,"0"
"SPA","15/5/2018","0","0","0","0","0","0",,,"0"
"SPA","16/5/2018","0","-43838","0","0","0","43838",,"-1","0"
"SPA","17/5/2018","0","0","0","0","0","0",,,"0"
"SPA","18/5/2018","0","41179","0","0","0","-41179",,"-1","0"
"SPA","19/5/2018","0","0","0","0","0","0",,,"0"
"SPA","20/5/2018","0","0","0","0","0","0",,,"0"
"SPA","21/5/2018","0","0","0","0","0","0",,,"0"
"SPA","22/5/2018","0","-54","0","0","0","54",,"-1","0"
"SPA","23/5/2018","1","-828","1","0","0","828","0","-1","0"
"SPA","24/5/2018","1","0","1","0","0","0","0",,"0"
"SPA","25/5/2018","0","0","0","0","0","0",,,"0"
"SPA","26/5/2018","0","0","0","0","0","0",,,"0"
"SPA","27/5/2018","0","0","0","0","0","0",,,"0"
"SPA","28/5/2018","0","0","0","0","0","0",,,"0"
"SPA","29/5/2018","0","0","0","0","0","0",,,"0"
"SPA","30/5/2018","0","0","0","0","0","0",,,"0"
"SPA","31/5/2018","0","0","0","0","0","0",,,"0"
"SPA","1/6/2018","0","0","0","0","0","0",,,"0"
"SPA","2/6/2018","0","0","0","0","0","0",,,"0"
"SPA","3/6/2018","0","0","0","0","0","0",,,"0"
"SPA","4/6/2018","0","0","0","0","0","0",,,"0"
"SPA","5/6/2018","0","0","0","0","0","0",,,"0"
"SPA","6/6/2018","0","0","0","0","0","0",,,"0"
"SPA","7/6/2018","0","0","0","0","0","0",,,"0"
"SPA","8/6/2018","0","-4780","0","0","0","4780",,"-1","0"
"SPA","9/6/2018","0","0","0","0","0","0",,,"0"
"SPA","10/6/2018","0","0","0","0","0","0",,,"0"
"SPA","11/6/2018","0","0","0","0","0","0",,,"0"
"SPA","12/6/2018","0","0","0","0","0","0",,,"0"
"SPA","13/6/2018","0","0","0","0","0","0",,,"0"
"SPA","14/6/2018","0","0","0","0","0","0",,,"0"
"SPA","15/6/2018","0","0","0","0","0","0",,,"0"
"SPA","16/6/2018","0","0","0","0","0","0",,,"0"
"SPA","17/6/2018","0","0","0","0","0","0",,,"0"
"SPA","18/6/2018","0","0","0","0","0","0",,,"0"
"SPA","19/6/2018","0","0","0","0","0","0",,,"0"
"SPA","20/6/2018","0","0","0","0","0","0",,,"0"
"SPA","21/6/2018","0","0","0","0","0","0",,,"0"
"SPA","22/6/2018","0","0","0","0","0","0",,,"0"
"SPA","23/6/2018","0","0","0","0","0","0",,,"0"
"SPA","24/6/2018","0","0","0","0","0","0",,,"0"
"SPA","25/6/2018","0","0","0","0","0","0",,,"0"
"SPA","26/6/2018","0","0","0","0","0","0",,,"0"
"SPA","27/6/2018","0","0","0","0","0","0",,,"0"
"SPA","28/6/2018","0","0","0","0","0","0",,,"0"
"SPA","29/6/2018","0","0","0","0","0","0",,,"0"
"SPA","30/6/2018","0","0","0","0","0","0",,,"0"
"SPA","1/7/2018","0","0","0","0","0","0",,,"0"
"SPA","2/7/2018","0","0","0","0","0","0",,,"0"
"SPA","3/7/2018","0","0","0","0","0","0",,,"0"
"SPA","4/7/2018","0","0","0","0","0","0",,,"0"
"SPA","5/7/2018","0","0","0","0","0","0",,,"0"
"SPA","6/7/2018","0","0","0","0","0","0",,,"0"
"SPA","7/7/2018","0","0","0","0","0","0",,,"0"
"SPA","8/7/2018","0","0","0","0","0","0",,,"0"
"SPA","9/7/2018","0","0","0","0","0","0",,,"0"
"SPA","10/7/2018","0","0","0","0","0","0",,,"0"
"SPA","11/7/2018","0","0","0","0","0","0",,,"0"
"SPA","12/7/2018","0","0","0","0","0","0",,,"0"
"SPA","13/7/2018","0","0","0","0","0","0",,,"0"
"SPA","14/7/2018","0","0","0","0","0","0",,,"0"
"SPA","15/7/2018","0","0","0","0","0","0",,,"0"
"SPA","16/7/2018","0","0","0","0","0","0",,,"0"
"SPA","17/7/2018","0","0","0","0","0","0",,,"0"
"SPA","18/7/2018","0","0","0","0","0","0",,,"0"
"SPA","19/7/2018","0","0","0","0","0","0",,,"0"
"SPA","20/7/2018","0","0","0","0","0","0",,,"0"
"SPA","21/7/2018","0","0","0","0","0","0",,,"0"
"SPA","22/7/2018","0","0","0","0","0","0",,,"0"
"SPA","23/7/2018","0","0","0","0","0","0",,,"0"
"SPA","24/7/2018","0","0","0","0","0","0",,,"0"
"SPA","25/7/2018","0","0","0","0","0","0",,,"0"
"SPA","26/7/2018","0","0","0","0","0","0",,,"0"
"SPA","27/7/2018","0","0","0","0","0","0",,,"0"
"SPA","28/7/2018","0","0","0","0","0","0",,,"0"
"SPA","29/7/2018","0","0","0","0","0","0",,,"0"
"SPA","30/7/2018","0","0","0","0","0","0",,,"0"
"SPA","31/7/2018","0","0","0","0","0","0",,,"0"
"SPA","1/8/2018","0","0","0","0","0","0",,,"0"
"SPA","2/8/2018","0","0","0","0","0","0",,,"0"
"SPA","3/8/2018","0","0","0","0","0","0",,,"0"
"SPA","4/8/2018","0","0","0","0","0","0",,,"0"
"SPA","5/8/2018","0","0","0","0","0","0",,,"0"
"SPA","6/8/2018","0","0","0","0","0","0",,,"0"
"SPA","7/8/2018","0","0","0","0","0","0",,,"0"
"SPA","8/8/2018","0","0","0","0","0","0",,,"0"
"SPA","9/8/2018","0","985","0","0","0","-985",,"-1","0"
"SPA","10/8/2018","0","0","0","0","0","0",,,"0"
"SPA","11/8/2018","0","0","0","0","0","0",,,"0"
"SPA","12/8/2018","0","0","0","0","0","0",,,"0"
"SPA","13/8/2018","0","0","0","0","0","0",,,"0"
"SPA","14/8/2018","0","0","0","0","0","0",,,"0"
"SPA","15/8/2018","0","0","0","0","0","0",,,"0"
"SPA","16/8/2018","0","0","0","0","0","0",,,"0"
"SPA","17/8/2018","0","0","0","0","0","0",,,"0"
"SPA","18/8/2018","0","0","0","0","0","0",,,"0"
"SPA","19/8/2018","0","0","0","0","0","0",,,"0"
"SPA","20/8/2018","0","0","0","0","0","0",,,"0"
"SPA","21/8/2018","0","0","0","0","0","0",,,"0"
"SPA","22/8/2018","0","0","0","0","0","0",,,"0"
"SPA","23/8/2018","0","0","0","0","0","0",,,"0"
"SPA","24/8/2018","0","0","0","0","0","0",,,"0"
"SPA","25/8/2018","0","0","0","0","0","0",,,"0"
"SPA","26/8/2018","0","0","0","0","0","0",,,"0"
"SPA","27/8/2018","0","0","0","0","0","0",,,"0"
"SPA","28/8/2018","0","0","0","0","0","0",,,"0"
"SPA","29/8/2018","0","0","0","0","0","0",,,"0"
"SPA","30/8/2018","0","0","0","0","0","0",,,"0"
"SPA","31/8/2018","0","0","0","0","0","0",,,"0"
"SPA","1/9/2018","0","0","0","0","0","0",,,"0"
"SPA","2/9/2018","0","0","0","0","0","0",,,"0"
"SPA","3/9/2018","0","0","0","0","0","0",,,"0"
"SPA","4/9/2018","0","0","0","0","0","0",,,"0"
"SPA","5/9/2018","0","0","0","0","0","0",,,"0"
"SPA","6/9/2018","0","0","0","0","0","0",,,"0"
"SPA","7/9/2018","0","0","0","0","0","0",,,"0"
"SPA","8/9/2018","0","0","0","0","0","0",,,"0"
"SPA","9/9/2018","0","0","0","0","0","0",,,"0"
"SPA","10/9/2018","0","0","0","0","0","0",,,"0"
"SPA","11/9/2018","0","0","0","0","0","0",,,"0"
"SPA","12/9/2018","0","0","0","0","0","0",,,"0"
"SPA","13/9/2018","0","0","0","0","0","0",,,"0"
"SPA","14/9/2018","0","0","0","0","0","0",,,"0"
"SPA","15/9/2018","0","0","0","0","0","0",,,"0"
"SPA","16/9/2018","0","0","0","0","0","0",,,"0"
"SPA","17/9/2018","0","0","0","0","0","0",,,"0"
"SPA","18/9/2018","0","0","0","0","0","0",,,"0"
"SPA","19/9/2018","0","0","0","0","0","0",,,"0"
"SPA","20/9/2018","2","0","2","0","0","0","0",,"0"
"SPA","21/9/2018","2","0","2","0","0","0","0",,"0"
"SPA","22/9/2018","2","0","2","0","0","0","0",,"0"
"SPA","23/9/2018","2","0","2","0","0","0","0",,"0"
"SPA","24/9/2018","2","0","2","0","0","0","0",,"0"
"SPA","25/9/2018","3","0","3","0","0","0","0",,"0"
"SPA","26/9/2018","4","0","4","0","0","0","0",,"0"
"SPA","27/9/2018","4","0","4","0","0","0","0",,"0"
"SPA","28/9/2018","18","2778","18","964150","0","961372","0","346.0662347012239","0"
"SPA","29/9/2018","18","3390","18","999725","0","996335","0","293.9041297935103","0"
"SPA","30/9/2018","18","3431","18","1000523","0","997092","0","290.6126493733605","0"
"SPA","1/10/2018","15","3039","15","999743","0","996704","0","327.971043106285","0"
"SPA","2/10/2018","28","6975","27","718990","-1","712015","-0.035714285","102.08100358422939","0"
"SPA","3/10/2018","27","6203","26","418017","-1","411814","-0.037037037","66.38948895695631","0"
"SPA","4/10/2018","22","6013","22","1663794","0","1657781","0","275.69948445035755","0"
"SPA","5/10/2018","23","6504","22","2306998","-1","2300494","-0.04347826","353.70448954489547","0"
"SPA","6/10/2018","42","10320","41","2595229","-1","2584909","-0.023809523","250.47567829457364","0"
"SPA","7/10/2018","28","7383","28","833884","0","826501","0","111.9464987132602","0"
"SPA","8/10/2018","26","8418","26","108828","0","100410","0","11.928011404133999","0"
"SPA","9/10/2018","32","5451","32","107737","0","102286","0","18.76463034305632","0"
"SPA","10/10/2018","21","4686","20","251687","-1","247001","-0.047619047","52.7104139991464","0"
"SPA","11/10/2018","23","6429","23","380075","0","373646","0","58.118836522009644","0"
"SPA","12/10/2018","32","10701","32","2817531","0","2806830","0","262.296047098402","0"
"SPA","13/10/2018","47","15642","45","5489007","-2","5473365","-0.042553191","349.91465285769084","0"
"SPA","14/10/2018","57","16280","55","4985312","-2","4969032","-0.035087719","305.22309582309583","0"
"SPA","15/10/2018","46","15091","45","2109756","-1","2094665","-0.02173913","138.80226625140813","0"
"SPA","16/10/2018","25","10936","25","1094837","0","1083901","0","99.1131126554499","0"
"SPA","17/10/2018","32","13333","31","24792","-1","11459","-0.03125","0.859446486162154","0"
"SPA","18/10/2018","54","17405","53","736585","-1","719180","-0.018518518","41.320310255673654","0"
"SPA","19/10/2018","54","14480","53","1069855","-1","1055375","-0.018518518","72.8850138121547","0"
"SPA","20/10/2018","30","8195","28","1437887","-2","1429692","-0.066666666","174.45906040268457","0"
"SPA","21/10/2018","24","8043","24","892322","0","884279","0","109.94392639562352","0"
"SPA","22/10/2018","22","7063","22","554247","0","547184","0","77.47189579498797","0"
"SPA","23/10/2018","15","3988","15","656834","0","652846","0","163.7026078234704","0"
"SPA","24/10/2018","14","4254","12","164248","-2","159994","-0.142857142","37.610249177244945","1"
"SPA","25/10/2018","19","6495","18","403768","-1","397273","-0.052631578","61.165973826020014","0"
"SPA","26/10/2018","34","15559","33","533289","-1","517730","-0.029411764","33.27527476058873","0"
"SPA","27/10/2018","56","14217","56","440636","0","426419","0","29.993599212210732","0"
"SPA","28/10/2018","29","9507","29","888804","0","879297","0","92.48942884190596","0"
"SPA","29/10/2018","50","20130","49","8017119","-1","7996989","-0.02","397.2672131147541","0"
"SPA","30/10/2018","54","21276","52","7911681","-2","7890405","-0.037037037","370.8594190637338","0"
"SPA","31/10/2018","45","11413","37","1399554","-8","1388141","-0.177777777","121.62805572592657","1"
"SPA","1/11/2018","52","15737","43","1397021","-9","1381284","-0.173076923","87.77301899980937","1"
"SPA","2/11/2018","45","5074","38","1101270","-7","1096196","-0.155555555","216.04178163184864","1"
"SPA","3/11/2018","57","16283","56","30567","-1","14284","-0.017543859","0.8772339249524044","0"
"SPA","4/11/2018","55","15611","55","29520","0","13909","0","0.8909743129844341","0"
"SPA","5/11/2018","48","16634","48","26506","0","9872","0","0.5934832271251653","0"
"SPA","6/11/2018","44","15063","44","307252","0","292189","0","19.397795923786763","0"
"SPA","7/11/2018","32","7498","31","630609","-1","623111","-0.03125","83.10362763403575","0"
"SPA","8/11/2018","28","11295","28","923196","0","911901","0","80.73492695883134","0"
"SPA","9/11/2018","45","22053","45","323494","0","301441","0","13.668933931891353","0"
"SPA","10/11/2018","56","26166","55","9095433","-1","9069267","-0.017857142","346.6050217839945","0"
"SPA","11/11/2018","29","24183","28","30678","-1","6495","-0.034482758","0.2685770996154323","0"
"SPA","12/11/2018","14","7685","14","10662","0","2977","0","0.3873780091086532","0"
"SPA","13/11/2018","57","20031","57","9396126","0","9376095","0","468.07922719784335","0"
"SPA","14/11/2018","56","24247","56","9145414","0","9121167","0","376.17713531570917","0"
"SPA","15/11/2018","56","29684","54","9312600","-2","9282916","-0.035714285","312.7245654224498","0"
"SPA","16/11/2018","56","30260","54","9312064","-2","9281804","-0.035714285","306.7350958360872","0"
"SPA","17/11/2018","52","19619","51","8820101","-1","8800482","-0.019230769","448.56934604210204","0"
"SPA","18/11/2018","46","6493","45","1120725","-1","1114232","-0.02173913","171.6051131988295","0"
"SPA","19/11/2018","57","20317","56","833570","-1","813253","-0.017543859","40.028202982723826","0"
"SPA","20/11/2018","54","19636","53","35222","-1","15586","-0.018518518","0.7937461804848238","0"
"SPA","21/11/2018","53","24896","53","34095","0","9199","0","0.3694971079691517","0"
"SPA","22/11/2018","51","24767","51","1845452","0","1820685","0","73.5125368433803","0"
"SPA","23/11/2018","51","30560","50","17055307","-1","17024747","-0.019607843","557.0925065445026","0"
"SPA","24/11/2018","57","34494","56","17057568","-1","17023074","-0.017543859","493.50826230648806","0"
"SPA","25/11/2018","55","31904","52","17052995","-3","17021091","-0.054545454","533.5096226178536","0"
"SPA","26/11/2018","48","21308","46","1722665","-2","1701357","-0.041666666","79.84592641261499","0"
"SPA","27/11/2018","43","18094","40","1718171","-3","1700077","-0.069767441","93.95805239305847","0"
"SPA","28/11/2018","46","21087","42","1721023","-4","1699936","-0.086956521","80.61535543225683","0"
"SPA","29/11/2018","52","30573","49","14412614","-3","14382041","-0.057692307","470.4164131750237","0"
"SPA","30/11/2018","57","34547","54","19085458","-3","19050911","-0.052631578","551.4490693837381","0"
"SPA","1/12/2018","55","35549","53","25326385","-2","25290836","-0.036363636","711.4359335002391","0"
"SPA","2/12/2018","45","20468","45","13669079","0","13648611","0","666.8268028141489","0"
"SPA","3/12/2018","32","12347","32","3016656","0","3004309","0","243.32299343970195","0"
"SPA","4/12/2018","56","23413","55","17708740","-1","17685327","-0.017857142","755.3635587067014","0"
"SPA","5/12/2018","21","10021","20","2970843","-1","2960822","-0.047619047","295.46173036623094","0"
"SPA","6/12/2018","27","15334","26","1005273","-1","989939","-0.037037037","64.55843224207644","0"
"SPA","7/12/2018","32","15264","30","1104865","-2","1089601","-0.0625","71.38371331236897","0"
"SPA","8/12/2018","37","15825","36","322739","-1","306914","-0.027027027","19.394249605055293","0"
"SPA","9/12/2018","36","14577","35","860159","-1","845582","-0.027777777","58.0079577416478","0"
"SPA","10/12/2018","34","12106","33","1516366","-1","1504260","-0.029411764","124.25739302825045","0"
"SPA","11/12/2018","25","12395","24","1310208","-1","1297813","-0.04","104.70455828963291","0"
"SPA","12/12/2018","32","14607","32","1316568","0","1301961","0","89.13267611419182","0"
"SPA","13/12/2018","52","17936","52","1552728","0","1534792","0","85.57047279214987","0"
"SPA","14/12/2018","45","16289","45","1300177","0","1283888","0","78.81932592547118","0"
"SPA","15/12/2018","50","18923","50","1876953","0","1858030","0","98.18897637795276","0"
"SPA","16/12/2018","48","21429","48","811758","0","790329","0","36.881282374352516","0"
"SPA","17/12/2018","36","16684","36","702626","0","685942","0","41.113761687844644","0"
"SPA","18/12/2018","50","24218","48","32120","-2","7902","-0.04","0.32628623338013046","0"
"SPA","19/12/2018","39","22293","37","1456480","-2","1434187","-0.051282051","64.3335127618535","0"
"SPA","20/12/2018","42","23921","40","1460745","-2","1436824","-0.047619047","60.06538188202834","0"
"SPA","21/12/2018","41","34340","26","1457557","-15","1423217","-0.365853658","41.44487478159581","1"
"SPA","22/12/2018","55","39630","39","42112","-16","2482","-0.29090909","0.062629321221297","1"
"SPA","23/12/2018","55","42097","39","41783","-16","-314","-0.29090909","-0.007458963821649999","1"
"SPA","24/12/2018","57","41105","39","42642","-18","1537","-0.315789473","0.03739204476341078","1"
"SPA","25/12/2018","56","42653","50","58721","-6","16068","-0.107142857","0.3767144163364828","1"
"SPA","26/12/2018","52","47205","50","119019","-2","71814","-0.038461538","1.521321893867175","0"
"SPA","27/12/2018","45","45049","45","116785","0","71736","0","1.592399387333792","0"
"SPA","28/12/2018","55","49347","46","66427","-9","17080","-0.163636363","0.3461203315297789","1"
"SPA","29/12/2018","56","47021","47","62909","-9","15888","-0.160714285","0.3378915803577125","1"
"SPA","30/12/2018","49","47937","46","61148","-3","13211","-0.061224489","0.275590879696268","0"
"SPA","31/12/2018","54","54706","51","69661","-3","14955","-0.055555555","0.2733703798486455","0"
"SPA","1/1/2019","53","42764","50","59397","-3","16633","-0.056603773","0.388948648395847","0"
"SPA","2/1/2019","56","47103","53","62054","-3","14951","-0.053571428","0.31741078062968386","0"
"SPA","3/1/2019","53","40956","51","55153","-2","14197","-0.037735849","0.3466402969039945","0"
"SPA","4/1/2019","55","36812","53","53391","-2","16579","-0.036363636","0.4503694447462784","0"
"SPA","5/1/2019","55","35178","54","1697863","-1","1662685","-0.018181818","47.264909886861105","0"
"SPA","6/1/2019","46","30443","46","1690553","0","1660110","0","54.531747856650135","0"
"SPA","7/1/2019","43","27423","43","38401","0","10978","0","0.40032089851584435","0"
"SPA","8/1/2019","57","36177","57","50913","0","14736","0","0.4073306244298864","0"
"SPA","9/1/2019","54","34876","54","51088","0","16212","0","0.4648468861107925","0"
"SPA","10/1/2019","55","36468","55","51887","0","15419","0","0.4228090380607656","0"
"SPA","11/1/2019","41","26681","41","41553","0","14872","0","0.5574003972864585","0"
"SPA","12/1/2019","53","27937","53","2192636","0","2164699","0","77.48501986612736","0"
"SPA","13/1/2019","54","26377","54","2188823","0","2162446","0","81.98225726959093","0"
"SPA","14/1/2019","50","18698","49","1443068","-1","1424370","-0.02","76.17766606054123","0"
"SPA","15/1/2019","50","26282","49","1439600","-1","1413318","-0.02","53.77513126854882","0"
"SPA","16/1/2019","33","20606","30","1429543","-3","1408937","-0.09090909","68.37508492672038","0"
"SPA","17/1/2019","37","21488","34","1763588","-3","1742100","-0.081081081","81.07315711094564","0"
"SPA","18/1/2019","46","31916","45","2597729","-1","2565813","-0.02173913","80.39268705351547","0"
"SPA","19/1/2019","41","25144","41","1244741","0","1219597","0","48.50449411390392","0"
"SPA","20/1/2019","40","24833","40","415913","0","391080","0","15.748399307373253","0"
"SPA","21/1/2019","36","21290","36","80449","0","59159","0","2.7787224048849226","0"
"SPA","22/1/2019","57","32562","50","210346","-7","177784","-0.122807017","5.4598611878877215","1"
"SPA","23/1/2019","53","29890","46","42550","-7","12660","-0.132075471","0.42355302776848447","1"
"SPA","24/1/2019","42","26467","35","36367","-7","9900","-0.166666666","0.37405070465107493","1"
"SPA","25/1/2019","30","21228","30","31775","0","10547","0","0.4968437912191445","0"
"SPA","26/1/2019","43","19126","43","29449","0","10323","0","0.5397364843668305","0"
"SPA","27/1/2019","44","20752","44","33073","0","12321","0","0.5937259059367772","0"
"SPA","28/1/2019","52","24739","52","39359","0","14620","0","0.5909697239177008","0"
"SPA","29/1/2019","48","21470","48","35256","0","13786","0","0.6421052631578947","0"
"SPA","30/1/2019","43","24100","43","908686","0","884586","0","36.7048132780083","0"
"SPA","31/1/2019","48","27738","48","913762","0","886024","0","31.9426058115221","0"
"SPA","1/2/2019","42","26690","42","40856","0","14166","0","0.5307605844885726","0"
"SPA","2/2/2019","51","24554","51","41252","0","16698","0","0.6800521299991855","0"
"SPA","3/2/2019","56","28379","56","42103","0","13724","0","0.48359702596990733","0"
"SPA","4/2/2019","53","26135","52","39896","-1","13761","-0.018867924","0.5265352974937823","0"
"SPA","5/2/2019","56","19224","56","41236","0","22012","0","1.1450270495214316","0"
"SPA","6/2/2019","55","29653","55","362605","0","332952","0","11.22827369911982","0"
"SPA","7/2/2019","41","22303","40","35955","-1","13652","-0.024390243","0.6121149621127202","0"
"SPA","8/2/2019","30","19163","29","26809","-1","7646","-0.033333333","0.3989980691958462","0"
"SPA","9/2/2019","42","19695","42","768411","0","748716","0","38.01553693830922","0"
"SPA","10/2/2019","46","21062","46","32957","0","11895","0","0.564761181274333","0"
"SPA","11/2/2019","47","20903","47","31933","0","11030","0","0.5276754532842176","0"
"SPA","12/2/2019","56","24887","56","37701","0","12814","0","0.514887290553301","0"
"SPA","13/2/2019","54","32715","56","48873","2","16158","0.037037037","0.49390187987161854","0"
"SPA","14/2/2019","38","26297","38","1012760","0","986463","0","37.51237783777617","0"
"SPA","15/2/2019","37","24201","36","1611743","-1","1587542","-0.027027027","65.59819842155282","0"
"SPA","16/2/2019","48","29733","48","1720085","0","1690352","0","56.85104093095214","0"
"SPA","17/2/2019","51","32188","52","1721910","1","1689722","0.019607843","52.49540201317261","0"
"SPA","18/2/2019","49","32648","49","578864","0","546216","0","16.730458221024257","0"
"SPA","19/2/2019","47","27764","47","393584","0","365820","0","13.176055323440426","0"
"SPA","20/2/2019","42","24522","42","1047628","0","1023106","0","41.721963950738115","0"
"SPA","21/2/2019","46","32755","46","1054071","0","1021316","0","31.180460998320868","0"
"SPA","22/2/2019","42","31859","42","1052095","0","1020236","0","32.02347845192881","0"
"SPA","23/2/2019","54","38493","54","798633","0","760140","0","19.747486555997195","0"
"SPA","24/2/2019","50","28453","50","789192","0","760739","0","26.73668857413981","0"
"SPA","25/2/2019","46","28193","46","44119","0","15926","0","0.5648919944667116","0"
"SPA","26/2/2019","52","23575","52","36121","0","12546","0","0.5321739130434783","0"
"SPA","27/2/2019","56","29768","56","38585","0","8817","0","0.2961905401773717","0"
"SPA","28/2/2019","54","29752","54","36421","0","6669","0","0.2241529981177736","0"
"SPA","1/3/2019","46","25756","47","230700","1","204944","0.02173913","7.95713620127349","0"
"SPA","2/3/2019","35","20392","36","225085","1","204693","0.028571428","10.037907022361711","0"
"SPA","3/3/2019","40","23721","41","229140","1","205419","0.025","8.659795118249653","0"
"SPA","4/3/2019","42","18751","43","443230","1","424479","0.023809523","22.637672657458268","0"
"SPA","5/3/2019","41","18751","41","463159","0","444408","0","23.700495973548076","0"
"SPA","6/3/2019","45","20552","47","345564","2","325012","0.044444444","15.814130011677696","0"
"SPA","7/3/2019","44","21791","46","789452","2","767661","0.045454545","35.22835115414621","0"
"SPA","8/3/2019","46","23423","48","1164229","2","1140806","0.04347826","48.70452119711395","0"
"SPA","9/3/2019","54","21329","57","1125097","3","1103768","0.055555555","51.74963664494351","0"
"SPA","10/3/2019","47","19119","49","31877","2","12758","0.042553191","0.6672943145562006","0"
"SPA","11/3/2019","51","19966","53","32840","2","12874","0.039215686","0.6447961534608835","0"
"SPA","12/3/2019","57","22778","57","36021","0","13243","0","0.5813943278602159","0"
"SPA","13/3/2019","52","21415","51","36053","-1","14638","-0.019230769","0.6835395750642074","0"
"SPA","14/3/2019","47","23107","46","81761","-1","58654","-0.021276595","2.538364997619769","0"
"SPA","15/3/2019","42","24617","43","77480","1","52863","0.023809523","2.1474184506641754","0"
"SPA","16/3/2019","55","27341","57","255092","2","227751","0.036363636","8.330017190300282","0"
"SPA","17/3/2019","40","21025","39","27262","-1","6237","-0.025","0.29664684898929844","0"
"SPA","18/3/2019","57","26979","56","38826","-1","11847","-0.017543859","0.4391193150227955","0"
"SPA","19/3/2019","55","21193","54","493787","-1","472594","-0.018181818","22.29953286462511","0"
"SPA","20/3/2019","44","18854","43","535370","-1","516516","-0.022727272","27.39556592765461","0"
"SPA","21/3/2019","39","15874","39","1680629","0","1664755","0","104.87306287010206","0"
"SPA","22/3/2019","36","15100","36","1679842","0","1664742","0","110.24781456953643","0"
"SPA","23/3/2019","36","13645","36","1878804","0","1865159","0","136.69175522169292","0"
"SPA","24/3/2019","38","14876","38","20866","0","5990","0","0.4026620059155687","0"
"SPA","25/3/2019","42","15809","42","25058","0","9249","0","0.5850464925042698","0"
"SPA","26/3/2019","54","21866","55","29018","1","7152","0.018518518","0.32708314277874323","0"
"SPA","27/3/2019","53","23771","56","34103","3","10332","0.056603773","0.4346472592654916","0"
"SPA","28/3/2019","48","21577","50","576708","2","555131","0.041666666","25.72790471335218","0"
"SPA","29/3/2019","42","17649","41","869893","-1","852244","-0.023809523","48.28851493002436","0"
"SPA","30/3/2019","33","12777","32","1446536","-1","1433759","-0.03030303","112.21405650778743","0"
"SPA","31/3/2019","25","9247","25","896826","0","887579","0","95.98561695685088","0"
"SPA","1/4/2019","17","6709","17","337620","0","330911","0","49.32344611715606","0"
"SPA","2/4/2019","30","10157","30","557194","0","547037","0","53.858127399822784","0"
"SPA","3/4/2019","22","5455","21","672891","-1","667436","-0.045454545","122.35307057745187","0"
"SPA","4/4/2019","41","13684","42","2557111","1","2543427","0.024390243","185.86867874890382","0"
"SPA","5/4/2019","45","12008","52","2915268","7","2903260","0.155555555","241.7771485676216","1"
"SPA","6/4/2019","47","10243","55","2916675","8","2906432","0.170212765","283.7481206677731","1"
"SPA","7/4/2019","21","3879","23","1111324","2","1107445","0.095238095","285.4975509151843","0"
"SPA","8/4/2019","26","6503","28","326410","2","319907","0.076923076","49.19375672766415","0"
"SPA","9/4/2019","29","7796","31","326828","2","319032","0.068965517","40.92252437147255","0"
"SPA","10/4/2019","36","8596","36","396494","0","387898","0","45.12540716612378","0"
"SPA","11/4/2019","16","3399","16","173443","0","170044","0","50.02765519270373","0"
"SPA","12/4/2019","23","4234","24","950186","1","945952","0.04347826","223.4180444024563","0"
"SPA","13/4/2019","22","3978","23","1046811","1","1042833","0.045454545","262.15007541478127","0"
"SPA","14/4/2019","36","8308","36","260877","0","252569","0","30.400698122291768","0"
"SPA","15/4/2019","42","10346","40","542257","-2","531911","-0.047619047","51.412236613183836","0"
"SPA","16/4/2019","31","9811","29","704523","-2","694712","-0.064516129","70.80949954133116","0"
"SPA","17/4/2019","19","6920","17","915837","-2","908917","-0.105263157","131.346387283237","1"
"SPA","18/4/2019","38","13071","38","2307805","0","2294734","0","175.55917680361105","0"
"SPA","19/4/2019","50","17196","53","3238738","3","3221542","0.06","187.34252151663176","0"
"SPA","20/4/2019","50","15309","53","3400684","3","3385375","0.06","221.13625971650663","0"
"SPA","21/4/2019","25","10186","24","291655","-1","281469","-0.04","27.632927547614372","0"
"SPA","22/4/2019","19","7024","18","8597","-1","1573","-0.052631578","0.22394646924829156","0"
"SPA","23/4/2019","25","31971","24","2570247","-1","2538276","-0.04","79.39307497419536","0"
"SPA","24/4/2019","31","7843","23","2957109","-8","2949266","-0.258064516","376.03799566492415","1"
"SPA","25/4/2019","40","9402","38","4000773","-2","3991371","-0.05","424.52361199744735","0"
"SPA","26/4/2019","26","6139","29","2402137","3","2395998","0.115384615","390.29125264701094","1"
"SPA","27/4/2019","32","7455","35","3007513","3","3000058","0.09375","402.42226693494297","0"
"SPA","28/4/2019","11","2857","10","482214","-1","479357","-0.09090909","167.78333916695834","0"
"SPA","29/4/2019","1","-846","0","0","-1","846","-1","-1","1"
"SPA","30/4/2019","0","0","0","0","0","0",,,"0"
"SPA","1/5/2019","0","0","0","0","0","0",,,"0"
"SPA","2/5/2019","0","0","0","0","0","0",,,"0"
"SPA","3/5/2019","0","0","0","0","0","0",,,"0"
"SPA","4/5/2019","0","0","0","0","0","0",,,"0"
"SPA","5/5/2019","0","0","0","0","0","0",,,"0"
"SPA","6/5/2019","0","-1585","0","0","0","1585",,"-1","0"
"SPA","7/5/2019","0","0","0","0","0","0",,,"0"
"SPA","8/5/2019","0","0","0","0","0","0",,,"0"
"SPA","9/5/2019","0","149","0","0","0","-149",,"-1","0"
"SPA","10/5/2019","0","137","0","0","0","-137",,"-1","0"
"SPA","11/5/2019","0","0","0","0","0","0",,,"0"
"SPA","12/5/2019","0","0","0","0","0","0",,,"0"
"SPA","13/5/2019","0","0","0","0","0","0",,,"0"
"SPA","14/5/2019","0","0","0","0","0","0",,,"0"
"SPA","15/5/2019","0","0","0","0","0","0",,,"0"
"SPA","16/5/2019","0","0","0","0","0","0",,,"0"
"SPA","17/5/2019","0","0","0","0","0","0",,,"0"
"SPA","18/5/2019","0","0","0","0","0","0",,,"0"
"SPA","19/5/2019","0","0","0","0","0","0",,,"0"
"SPA","20/5/2019","0","0","0","0","0","0",,,"0"
"SPA","21/5/2019","0","0","0","0","0","0",,,"0"
"SPA","22/5/2019","0","0","0","0","0","0",,,"0"
"SPA","23/5/2019","0","0","0","0","0","0",,,"0"
"SPA","24/5/2019","0","0","0","0","0","0",,,"0"
"SPA","25/5/2019","0","0","0","0","0","0",,,"0"
"SPA","26/5/2019","0","0","0","0","0","0",,,"0"
"SPA","27/5/2019","0","0","0","0","0","0",,,"0"
"SPA","28/5/2019","0","0","0","0","0","0",,,"0"
"SPA","29/5/2019","0","0","0","0","0","0",,,"0"
"SPA","30/5/2019","0","0","0","0","0","0",,,"0"
"SPA","31/5/2019","0","0","0","0","0","0",,,"0"
"SPA","1/6/2019","0","0","0","0","0","0",,,"0"
"SPA","2/6/2019","0","0","0","0","0","0",,,"0"
"SPA","3/6/2019","0","0","0","0","0","0",,,"0"
"SPA","4/6/2019","0","0","0","0","0","0",,,"0"
"SPA","5/6/2019","0","0","0","0","0","0",,,"0"
"SPA","6/6/2019","0","0","0","0","0","0",,,"0"
"SPA","7/6/2019","0","0","0","0","0","0",,,"0"
"SPA","8/6/2019","0","0","0","0","0","0",,,"0"
"SPA","9/6/2019","0","0","0","0","0","0",,,"0"
"SPA","10/6/2019","0","0","0","0","0","0",,,"0"
"SPA","11/6/2019","0","0","0","0","0","0",,,"0"
"SPA","12/6/2019","0","0","0","0","0","0",,,"0"
"SPA","13/6/2019","0","0","0","0","0","0",,,"0"
"SPA","14/6/2019","0","0","0","0","0","0",,,"0"
"SPA","15/6/2019","0","0","0","0","0","0",,,"0"
"SPA","16/6/2019","0","0","0","0","0","0",,,"0"
"SPA","17/6/2019","0","0","0","0","0","0",,,"0"
"SPA","18/6/2019","0","0","0","0","0","0",,,"0"
"SPA","19/6/2019","0","0","0","0","0","0",,,"0"
"SPA","20/6/2019","0","0","0","0","0","0",,,"0"
"SPA","21/6/2019","0","0","0","0","0","0",,,"0"
"SPA","22/6/2019","0","0","0","0","0","0",,,"0"
"SPA","23/6/2019","0","0","0","0","0","0",,,"0"
"SPA","24/6/2019","0","0","0","0","0","0",,,"0"
"SPA","25/6/2019","0","0","0","0","0","0",,,"0"
"SPA","26/6/2019","0","0","0","0","0","0",,,"0"
"SPA","27/6/2019","0","0","0","0","0","0",,,"0"
"SPA","28/6/2019","0","0","0","0","0","0",,,"0"
"SPA","29/6/2019","0","0","0","0","0","0",,,"0"
"SPA","30/6/2019","0","0","0","0","0","0",,,"0"
"SPA","1/7/2019","0","0","0","0","0","0",,,"0"
"SPA","2/7/2019","0","0","0","0","0","0",,,"0"
"SPA","3/7/2019","0","0","0","0","0","0",,,"0"
"SPA","4/7/2019","0","0","0","0","0","0",,,"0"
"SPA","5/7/2019","0","0","0","0","0","0",,,"0"
"SPA","6/7/2019","0","0","0","0","0","0",,,"0"
"SPA","7/7/2019","0","0","0","0","0","0",,,"0"
"SPA","8/7/2019","0","0","0","0","0","0",,,"0"
"SPA","9/7/2019","0","0","0","0","0","0",,,"0"
"SPA","10/7/2019","0","0","0","0","0","0",,,"0"
"SPA","11/7/2019","0","0","0","0","0","0",,,"0"
"SPA","12/7/2019","0","0","0","0","0","0",,,"0"
"SPA","13/7/2019","0","0","0","0","0","0",,,"0"
"SPA","14/7/2019","0","0","0","0","0","0",,,"0"
"SPA","15/7/2019","0","0","0","0","0","0",,,"0"
"SPA","16/7/2019","0","0","0","0","0","0",,,"0"
"SPA","17/7/2019","0","0","0","0","0","0",,,"0"
"SPA","18/7/2019","0","0","0","0","0","0",,,"0"
"SPA","19/7/2019","0","0","0","0","0","0",,,"0"
"SPA","20/7/2019","0","0","0","0","0","0",,,"0"
"SPA","21/7/2019","0","0","0","0","0","0",,,"0"
"SPA","22/7/2019","0","0","0","0","0","0",,,"0"
"SPA","23/7/2019","0","0","0","0","0","0",,,"0"
"SPA","24/7/2019","0","0","0","0","0","0",,,"0"
"SPA","25/7/2019","0","0","0","0","0","0",,,"0"
"SPA","26/7/2019","0","0","0","0","0","0",,,"0"
"SPA","27/7/2019","0","0","0","0","0","0",,,"0"
"SPA","28/7/2019","0","0","0","0","0","0",,,"0"
"SPA","29/7/2019","0","0","0","0","0","0",,,"0"
"SPA","30/7/2019","0","0","0","0","0","0",,,"0"
"SPA","31/7/2019","0","0","0","0","0","0",,,"0"
"SPA","1/8/2019","0","0","0","0","0","0",,,"0"
"SPA","2/8/2019","0","0","0","0","0","0",,,"0"
"SPA","3/8/2019","0","0","0","0","0","0",,,"0"
"SPA","4/8/2019","0","0","0","0","0","0",,,"0"
"SPA","5/8/2019","0","0","0","0","0","0",,,"0"
"SPA","6/8/2019","0","0","0","0","0","0",,,"0"
"SPA","7/8/2019","0","0","0","0","0","0",,,"0"
"SPA","8/8/2019","0","0","0","0","0","0",,,"0"
"SPA","9/8/2019","0","0","0","0","0","0",,,"0"
"SPA","10/8/2019","0","0","0","0","0","0",,,"0"
"SPA","11/8/2019","0","0","0","0","0","0",,,"0"
"SPA","12/8/2019","0","0","0","0","0","0",,,"0"
"SPA","13/8/2019","0","0","0","0","0","0",,,"0"
"SPA","14/8/2019","0","0","0","0","0","0",,,"0"
"SPA","15/8/2019","0","0","0","0","0","0",,,"0"
"SPA","16/8/2019","0","0","0","0","0","0",,,"0"
"SPA","17/8/2019","0","0","0","0","0","0",,,"0"
"SPA","18/8/2019","0","0","0","0","0","0",,,"0"
"SPA","19/8/2019","0","0","0","0","0","0",,,"0"
"SPA","20/8/2019","0","0","0","0","0","0",,,"0"
"SPA","21/8/2019","0","0","0","0","0","0",,,"0"
"SPA","22/8/2019","0","0","0","0","0","0",,,"0"
"SPA","23/8/2019","0","0","0","0","0","0",,,"0"
"SPA","24/8/2019","0","0","0","0","0","0",,,"0"
"SPA","25/8/2019","0","0","0","0","0","0",,,"0"
"SPA","26/8/2019","0","0","0","0","0","0",,,"0"
"SPA","27/8/2019","0","0","0","0","0","0",,,"0"
"SPA","28/8/2019","0","0","0","0","0","0",,,"0"
"SPA","29/8/2019","0","897","0","0","0","-897",,"-1","0"
"SPA","30/8/2019","0","-902","0","0","0","902",,"-1","0"
"SPA","31/8/2019","0","0","0","0","0","0",,,"0"
"SPA","1/9/2019","0","0","0","0","0","0",,,"0"
"SPA","2/9/2019","0","0","0","0","0","0",,,"0"
"SPA","3/9/2019","0","0","0","0","0","0",,,"0"
"SPA","4/9/2019","0","0","0","0","0","0",,,"0"
"SPA","5/9/2019","0","0","0","0","0","0",,,"0"
"SPA","6/9/2019","0","0","0","0","0","0",,,"0"
"SPA","7/9/2019","0","0","0","0","0","0",,,"0"
"SPA","8/9/2019","0","0","0","0","0","0",,,"0"
"SPA","9/9/2019","0","0","0","0","0","0",,,"0"
"SPA","10/9/2019","0","0","0","0","0","0",,,"0"
"SPA","11/9/2019","0","0","0","0","0","0",,,"0"
"SPA","12/9/2019","0","0","0","0","0","0",,,"0"
"SPA","13/9/2019","0","0","0","0","0","0",,,"0"
"SPA","14/9/2019","0","0","0","0","0","0",,,"0"
"SPA","15/9/2019","0","0","0","0","0","0",,,"0"
"SPA","16/9/2019","0","0","0","0","0","0",,,"0"
"SPA","17/9/2019","0","0","0","0","0","0",,,"0"
"SPA","18/9/2019","0","0","0","0","0","0",,,"0"
"SPA","19/9/2019","0","0","0","0","0","0",,,"0"
"SPA","20/9/2019","0","0","0","0","0","0",,,"0"
"SPA","21/9/2019","0","0","0","0","0","0",,,"0"
"SPA","22/9/2019","0","0","0","0","0","0",,,"0"
"SPA","23/9/2019","0","0","0","0","0","0",,,"0"
"SPA","24/9/2019","0","0","0","0","0","0",,,"0"
"SPA","25/9/2019","0","0","0","0","0","0",,,"0"
"SPA","26/9/2019","0","0","0","0","0","0",,,"0"
"SPA","27/9/2019","18","3558","18","1392889","0","1389331","0","390.48088813940416","0"
"SPA","28/9/2019","17","3854","17","1446889","0","1443035","0","374.4252724442138","0"
"SPA","29/9/2019","9","4785","9","6725","0","1940","0","0.4054336468129572","0"
"SPA","30/9/2019","11","3910","11","5291","0","1381","0","0.35319693094629157","0"
"SPA","1/10/2019","12","2898","12","658228","0","655330","0","226.1318150448585","0"
"SPA","2/10/2019","13","3783","13","957046","0","953263","0","251.9859899550621","0"
"SPA","3/10/2019","16","3982","16","1670182","0","1666200","0","418.4329482672024","0"
"SPA","4/10/2019","21","4875","24","2652317","3","2647442","0.142857142","543.0650256410256","1"
"SPA","5/10/2019","24","5230","27","2717226","3","2711996","0.125","518.5460803059274","1"
"SPA","6/10/2019","18","4492","18","2313091","0","2308599","0","513.9356634016028","0"
"SPA","7/10/2019","14","4067","14","170456","0","166389","0","40.91197442832555","0"
"SPA","8/10/2019","12","4048","12","195115","0","191067","0","47.200345849802375","0"
"SPA","9/10/2019","16","4093","16","952585","0","948492","0","231.73515758612265","0"
"SPA","10/10/2019","14","3105","14","951546","0","948441","0","305.456038647343","0"
"SPA","11/10/2019","35","8121","38","2844780","3","2836659","0.085714285","349.2992242334688","0"
"SPA","12/10/2019","35","8752","38","2846443","3","2837691","0.085714285","324.2334323583181","0"
"SPA","13/10/2019","22","6883","22","209310","0","202427","0","29.40970507046346","0"
"SPA","14/10/2019","24","8778","24","12634","0","3856","0","0.43928001822738666","0"
"SPA","15/10/2019","20","8786","20","11976","0","3190","0","0.36307762349191897","0"
"SPA","16/10/2019","15","16228","15","9794","0","-6434","0","-0.39647522800098595","0"
"SPA","17/10/2019","21","8606","20","109973","-1","101367","-0.047619047","11.778642807343713","0"
"SPA","18/10/2019","20","5809","21","840144","1","834335","0.05","143.62799104837322","0"
"SPA","19/10/2019","37","12105","38","919099","1","906994","0.027027027","74.92722015695993","0"
"SPA","20/10/2019","27","8699","27","232219","0","223520","0","25.694907460627658","0"
"SPA","21/10/2019","31","11938","31","21335","0","9397","0","0.7871502764282124","0"
"SPA","22/10/2019","36","16686","36","28548","0","11862","0","0.7108953613807982","0"
"SPA","23/10/2019","20","11223","20","18743","0","7520","0","0.6700525706139179","0"
"SPA","24/10/2019","33","13126","33","1543119","0","1529993","0","116.56201432271827","0"
"SPA","25/10/2019","30","9131","33","1933006","3","1923875","0.1","210.6970758953017","1"
"SPA","26/10/2019","37","11621","40","1937379","3","1925758","0.081081081","165.7136218914035","0"
"SPA","27/10/2019","23","8152","23","218347","0","210195","0","25.784470068694798","0"
"SPA","28/10/2019","22","7475","22","12198","0","4723","0","0.6318394648829432","0"
"SPA","29/10/2019","26","8872","26","1001024","0","992152","0","111.82957619477007","0"
"SPA","30/10/2019","38","13426","38","5314357","0","5300931","0","394.8257857887681","0"
"SPA","31/10/2019","33","13540","33","5051322","0","5037782","0","372.0666174298375","0"
"SPA","1/11/2019","31","22319","34","4371550","3","4349231","0.096774193","194.8667503024329","0"
"SPA","2/11/2019","56","23724","59","4704639","3","4680915","0.053571428","197.30715730905413","0"
"SPA","3/11/2019","35","13848","35","25118","0","11270","0","0.8138359329867129","0"
"SPA","4/11/2019","53","24556","53","38451","0","13895","0","0.5658494868871151","0"
"SPA","5/11/2019","50","22818","50","219736","0","196918","0","8.629941274432465","0"
"SPA","6/11/2019","30","18992","30","212612","0","193620","0","10.194818871103623","0"
"SPA","7/11/2019","27","7903","27","396848","0","388945","0","49.2148551183095","0"
"SPA","8/11/2019","27","11452","30","205180","3","193728","0.111111111","16.916521131680057","1"
"SPA","9/11/2019","57","18802","60","216863","3","198061","0.052631578","10.534038932028508","0"
"SPA","10/11/2019","31","13359","32","209004","1","195645","0.032258064","14.645183022681339","0"
"SPA","11/11/2019","29","11856","30","18799","1","6943","0.034482758","0.585610661268556","0"
"SPA","12/11/2019","46","18121","47","321660","1","303539","0.02173913","16.750676011257656","0"
"SPA","13/11/2019","57","25819","58","334969","1","309150","0.017543859","11.973740268794298","0"
"SPA","14/11/2019","55","26046","56","1597038","1","1570992","0.018181818","60.31605620824695","0"
"SPA","15/11/2019","44","22078","48","1297949","4","1275871","0.09090909","57.78924721442159","0"
"SPA","16/11/2019","44","21377","47","1298427","3","1277050","0.068181818","59.73943958460027","0"
"SPA","17/11/2019","34","20982","34","31393","0","10411","0","0.4961872080831189","0"
"SPA","18/11/2019","37","19446","39","30242","2","10796","0.054054054","0.5551784428674278","0"
"SPA","19/11/2019","39","17093","41","75092","2","57999","0.051282051","3.393143392031826","0"
"SPA","20/11/2019","46","22837","48","85791","2","62954","0.04347826","2.756666812628629","0"
"SPA","21/11/2019","53","27801","54","1852174","1","1824373","0.018867924","65.62256753354195","0"
"SPA","22/11/2019","57","27934","61","2055317","4","2027383","0.070175438","72.57761151285172","0"
"SPA","23/11/2019","57","24092","59","3094734","2","3070642","0.035087719","127.45483978084012","0"
"SPA","24/11/2019","51","19598","50","1604976","-1","1585378","-0.019607843","80.89488723339116","0"
"SPA","25/11/2019","57","22797","56","31813","-1","9016","-0.017543859","0.39549063473264023","0"
"SPA","26/11/2019","48","23370","48","33863","0","10493","0","0.4489944373127942","0"
"SPA","27/11/2019","40","17342","46","129704","6","112362","0.15","6.479183485180487","1"
"SPA","28/11/2019","44","20225","49","2945747","5","2925522","0.113636363","144.64880098887517","1"
"SPA","29/11/2019","35","16719","38","2841921","3","2825202","0.085714285","168.9815180333752","0"
"SPA","30/11/2019","30","15866","40","3000736","10","2984870","0.333333333","188.12996344384217","1"
"SPA","1/12/2019","16","6440","18","175265","2","168825","0.125","26.21506211180124","1"
"SPA","2/12/2019","20","7256","22","11484","2","4228","0.1","0.5826901874310915","1"
"SPA","3/12/2019","16","5947","17","8883","1","2936","0.0625","0.4936942996468808","0"
"SPA","4/12/2019","17","658","16","5900","-1","5242","-0.058823529","7.966565349544073","0"
"SPA","5/12/2019","20","5774","20","616926","0","611152","0","105.8455143747835","0"
"SPA","6/12/2019","24","12701","32","525950","8","513249","0.333333333","40.41012518699315","1"
"SPA","7/12/2019","46","18585","49","443383","3","424798","0.065217391","22.85703524347592","0"
"SPA","8/12/2019","51","20966","51","444032","0","423066","0","20.17867022798817","0"
"SPA","9/12/2019","48","22226","48","231386","0","209160","0","9.410600197966346","0"
"SPA","10/12/2019","47","20790","46","130657","-1","109867","-0.021276595","5.284607984607985","0"
"SPA","11/12/2019","31","17817","30","224551","-1","206734","-0.032258064","11.603187966548802","0"
"SPA","12/12/2019","32","14551","30","433010","-2","418459","-0.0625","28.758092227338327","0"
"SPA","13/12/2019","36","18139","38","656321","2","638182","0.055555555","35.18286564860246","0"
"SPA","14/12/2019","35","16931","37","1479482","2","1462551","0.057142857","86.38302522001064","0"
"SPA","15/12/2019","43","19154","42","1283582","-1","1264428","-0.023255813","66.01378302182312","0"
"SPA","16/12/2019","55","19062","55","6034526","0","6015464","0","315.57360193054245","0"
"SPA","17/12/2019","54","21392","54","4943782","0","4922390","0","230.10424457741212","0"
"SPA","18/12/2019","51","20205","50","5062614","-1","5042409","-0.019607843","249.56243504083147","0"
"SPA","19/12/2019","52","21374","51","5066122","-1","5044748","-0.019230769","236.02264433423787","0"
"SPA","20/12/2019","45","29513","48","172847","3","143334","0.066666666","4.856639447023346","0"
"SPA","21/12/2019","53","51257","54","69685","1","18428","0.018867924","0.3595216263144546","0"
"SPA","22/12/2019","47","44929","51","66106","4","21177","0.085106382","0.4713436755770215","0"
"SPA","23/12/2019","51","49231","58","74654","7","25423","0.137254901","0.5164022668643741","1"
"SPA","24/12/2019","57","58986","65","86548","8","27562","0.140350877","0.4672634184382735","1"
"SPA","25/12/2019","53","68131","63","101726","10","33595","0.188679245","0.49309418620011447","1"
"SPA","26/12/2019","54","56424","63","98033","9","41609","0.166666666","0.7374344250673472","1"
"SPA","27/12/2019","49","56808","64","80339","15","23531","0.306122448","0.41421982819321224","1"
"SPA","28/12/2019","52","56285","67","70332","15","14047","0.288461538","0.24956915696899706","1"
"SPA","29/12/2019","52","56171","62","69258","10","13087","0.192307692","0.23298499225579036","1"
"SPA","30/12/2019","57","62840","63","1127423","6","1064583","0.105263157","16.941168045830683","1"
"SPA","31/12/2019","57","66428","55","1129279","-2","1062851","-0.035087719","16.00004516167881","0"
"SPA","1/1/2020","49","50531","51","1120608","2","1070077","0.040816326","21.176644040292096","0"
"SPA","2/1/2020","52","46325","54","1113189","2","1066864","0.038461538","23.029983810037777","0"
"SPA","3/1/2020","49","44109","52","56055","3","11946","0.061224489","0.27082908250017","0"
"SPA","4/1/2020","38","38256","44","169914","6","131658","0.157894736","3.441499372647428","1"
"SPA","5/1/2020","51","38566","52","11302324","1","11263758","0.019607843","292.06446092413006","0"
"SPA","6/1/2020","44","34198","43","11291265","-1","11257067","-0.022727272","329.17325574595003","0"
"SPA","7/1/2020","50","38698","50","11840484","0","11801786","0","304.9714713938705","0"
"SPA","8/1/2020","54","46919","53","9303809","-1","9256890","-0.018518518","197.295125642064","0"
"SPA","9/1/2020","57","45667","56","9597091","-1","9551424","-0.017543859","209.1537434033328","0"
"SPA","10/1/2020","43","28860","44","875473","1","846613","0.023255813","29.335169785169786","0"
"SPA","11/1/2020","51","22327","53","582362","2","560035","0.039215686","25.08330720652125","0"
"SPA","12/1/2020","46","20853","52","34271","6","13418","0.130434782","0.6434565769913202","1"
"SPA","13/1/2020","41","18737","47","30498","6","11761","0.146341463","0.6276885307146288","1"
"SPA","14/1/2020","56","31984","56","7949408","0","7917424","0","247.54327163581792","0"
"SPA","15/1/2020","45","25894","45","7944969","0","7919075","0","305.8266393759172","0"
"SPA","16/1/2020","49","20576","49","7949229","0","7928653","0","385.33500194401245","0"
"SPA","17/1/2020","41","26499","43","254767","2","228268","0.048780487","8.61421185705121","0"
"SPA","18/1/2020","37","20838","41","250769","4","229931","0.108108108","11.034216335540838","1"
"SPA","19/1/2020","36","21252","37","29462","1","8210","0.027777777","0.3863165819687559","0"
"SPA","20/1/2020","34","20637","36","30735","2","10098","0.058823529","0.4893153074574793","0"
"SPA","21/1/2020","45","28634","45","41119","0","12485","0","0.4360201159460781","0"
"SPA","22/1/2020","57","34468","57","58017","0","23549","0","0.6832134153417663","0"
"SPA","23/1/2020","48","35091","48","50499","0","15408","0","0.43908694537060783","0"
"SPA","24/1/2020","45","28124","48","439204","3","411080","0.066666666","14.616697482577159","0"
"SPA","25/1/2020","42","17535","45","427815","3","410280","0.071428571","23.397775876817793","0"
"SPA","26/1/2020","40","14102","40","420318","0","406216","0","28.805559495107076","0"
"SPA","27/1/2020","48","20669","48","1604187","0","1583518","0","76.61318883351879","0"
"SPA","28/1/2020","50","27007","50","1332844","0","1305837","0","48.35179768208242","0"
"SPA","29/1/2020","32","-6778","32","1085781","0","1092559","0","-161.19194452640897","0"
"SPA","30/1/2020","38","53355","38","152772","0","99417","0","1.8633117795895418","0"
"SPA","31/1/2020","37","26412","40","467748","3","441336","0.081081081","16.70967741935484","0"
"SPA","1/2/2020","54","31981","56","1248973","2","1216992","0.037037037","38.053594321628466","0"
"SPA","2/2/2020","50","27357","50","935180","0","907823","0","33.18430383448477","0"
"SPA","3/2/2020","44","22251","44","1721894","0","1699643","0","76.38501640375713","0"
"SPA","4/2/2020","46","19393","46","826063","0","806670","0","41.59593667818285","0"
"SPA","5/2/2020","32","18502","32","825854","0","807352","0","43.635931250675604","0"
"SPA","6/2/2020","56","44067","56","860834","0","816767","0","18.534663126602673","0"
"SPA","7/2/2020","57","50937","60","71301","3","20364","0.052631578","0.3997879733788798","0"
"SPA","8/2/2020","52","29304","55","845576","3","816272","0.057692307","27.855309855309855","0"
"SPA","9/2/2020","51","20797","52","1694852","1","1674055","0.019607843","80.49502332067125","0"
"SPA","10/2/2020","40","18047","41","930932","1","912885","0.025","50.58375353244306","0"
"SPA","11/2/2020","56","25649","57","947062","1","921413","0.017857142","35.92393465632188","0"
"SPA","12/2/2020","48","32030","49","149740","1","117710","0.020833333","3.6749921948173587","0"
"SPA","13/2/2020","54","40401","54","986632","0","946231","0","23.420979678720823","0"
"SPA","14/2/2020","36","25455","37","1379765","1","1354310","0.027777777","53.204085641327836","0"
"SPA","15/2/2020","49","26832","50","1391013","1","1364181","0.020408163","50.84156976744186","0"
"SPA","16/2/2020","51","32206","51","1724078","0","1691872","0","52.532819971433895","0"
"SPA","17/2/2020","52","33407","52","1476185","0","1442778","0","43.18789475259676","0"
"SPA","18/2/2020","55","31317","55","549856","0","518539","0","16.557748187885174","0"
"SPA","19/2/2020","53","31525","53","852743","0","821218","0","26.04973830293418","0"
"SPA","20/2/2020","53","30274","53","1048804","0","1018530","0","33.64372068441567","0"
"SPA","21/2/2020","57","32069","57","715563","0","683494","0","21.313230845988336","0"
"SPA","22/2/2020","56","30849","56","1002488","0","971639","0","31.49661253201076","0"
"SPA","23/2/2020","52","34288","52","647718","0","613430","0","17.89051563229118","0"
"SPA","24/2/2020","57","34875","58","654634","1","619759","0.017543859","17.770867383512545","0"
"SPA","25/2/2020","47","29602","47","354106","0","324504","0","10.962232281602594","0"
"SPA","26/2/2020","48","31853","48","362645","0","330792","0","10.384955891124855","0"
"SPA","27/2/2020","56","36526","55","364275","-1","327749","-0.017857142","8.973032908065488","0"
"SPA","28/2/2020","44","27802","47","1723227","3","1695425","0.068181818","60.98212358823106","0"
"SPA","29/2/2020","41","26862","44","2051253","3","2024391","0.073170731","75.3626312262676","0"
"SPA","1/3/2020","34","21942","34","31997","0","10055","0","0.4582535776137089","0"
"SPA","2/3/2020","38","23600","38","34019","0","10419","0","0.44148305084745765","0"
"SPA","3/3/2020","33","14093","33","1515721","0","1501628","0","106.55133754346129","0"
"SPA","4/3/2020","27","12060","27","1515726","0","1503666","0","124.6820895522388","0"
"SPA","5/3/2020","32","13778","32","1519479","0","1505701","0","109.28298737117143","0"
"SPA","6/3/2020","39","16469","41","2561368","2","2544899","0.051282051","154.52662578177183","0"
"SPA","7/3/2020","44","16200","45","1972940","1","1956740","0.022727272","120.78641975308642","0"
"SPA","8/3/2020","57","21225","55","2190269","-2","2169044","-0.035087719","102.19288574793875","0"
"SPA","9/3/2020","43","21764","43","1759306","0","1737542","0","79.83560007351589","0"
"SPA","10/3/2020","39","16613","39","239841","0","223228","0","13.436946969240957","0"
"SPA","11/3/2020","51","25780","50","1059066","-1","1033286","-0.019607843","40.08091543832428","0"
"SPA","12/3/2020","53","33722","52","910626","-1","876904","-0.018867924","26.00391435857897","0"
"SPA","13/3/2020","37","18824","40","1879377","3","1860553","0.081081081","98.8394071398215","0"
"SPA","14/3/2020","29","13439","32","2064188","3","2050749","0.103448275","152.59684500334848","1"
"SPA","15/3/2020","24","11395","24","253281","0","241886","0","21.227380430013163","0"
"SPA","16/3/2020","25","12527","25","254297","0","241770","0","19.299912189670312","0"
"SPA","17/3/2020","19","13850","19","249746","0","235896","0","17.03220216606498","0"
"SPA","18/3/2020","17","10887","17","13348","0","2461","0","0.22604941673555617","0"
"SPA","19/3/2020","5","1871","5","1842","0","-29","0","-0.01549973276322822","0"
"SPA","20/3/2020","3","1945","6","1304","3","-641","1","-0.3295629820051414","1"
"SPA","21/3/2020","0","39","3","454","3","415",,"10.64102564102564","0"
"SPA","22/3/2020","0","0","0","0","0","0",,,"0"
"SPA","23/3/2020","0","0","0","0","0","0",,,"0"
"SPA","24/3/2020","0","107","0","0","0","-107",,"-1","0"
"SPA","25/3/2020","0","38","0","0","0","-38",,"-1","0"
"SPA","26/3/2020","0","0","0","0","0","0",,,"0"
"SPA","27/3/2020","0","0","3","454","3","454",,,"0"
"SPA","28/3/2020","0","0","3","454","3","454",,,"0"
"SPA","29/3/2020","0","0","0","0","0","0",,,"0"
"SPA","30/3/2020","0","0","0","0","0","0",,,"0"
"SPA","31/3/2020","0","0","0","0","0","0",,,"0"
"SPA","1/4/2020","0","0","0","0","0","0",,,"0"
"SPA","2/4/2020","0","0","0","0","0","0",,,"0"
"SPA","3/4/2020","0","0","3","424","3","424",,,"0"
"SPA","4/4/2020","0","0","3","424","3","424",,,"0"
"SPA","5/4/2020","0","0","0","0","0","0",,,"0"
"SPA","6/4/2020","0","-2556","0","0","0","2556",,"-1","0"
"SPA","7/4/2020","0","0","0","0","0","0",,,"0"
"SPA","8/4/2020","0","0","0","0","0","0",,,"0"
"SPA","9/4/2020","0","0","0","0","0","0",,,"0"
"SPA","10/4/2020","0","0","3","424","3","424",,,"0"
"SPA","11/4/2020","0","0","3","424","3","424",,,"0"
"SPA","12/4/2020","0","0","0","0","0","0",,,"0"
"SPA","13/4/2020","0","0","0","0","0","0",,,"0"
"SPA","14/4/2020","0","0","0","0","0","0",,,"0"
"SPA","15/4/2020","0","0","0","0","0","0",,,"0"
"SPA","16/4/2020","0","0","4","2320","4","2320",,,"0"
"SPA","17/4/2020","0","0","7","2744","7","2744",,,"0"
"SPA","18/4/2020","0","0","7","2744","7","2744",,,"0"
"SPA","19/4/2020","0","0","0","0","0","0",,,"0"
"SPA","20/4/2020","0","0","0","0","0","0",,,"0"
"SPA","21/4/2020","0","78","0","0","0","-78",,"-1","0"
"SPA","22/4/2020","0","0","0","0","0","0",,,"0"
"SPA","23/4/2020","0","0","0","0","0","0",,,"0"
"SPA","24/4/2020","0","0","3","424","3","424",,,"0"
"SPA","25/4/2020","0","0","3","424","3","424",,,"0"
"SPA","26/4/2020","0","0","0","0","0","0",,,"0"
"SPA","27/4/2020","0","0","0","0","0","0",,,"0"
"SPA","28/4/2020","0","0","0","0","0","0",,,"0"
"SPA","29/4/2020","0","0","0","0","0","0",,,"0"
"SPA","30/4/2020","0","0","0","0","0","0",,,"0"
"SPA","1/5/2020","0","0","0","0","0","0",,,"0"
"SPA","2/5/2020","0","0","0","0","0","0",,,"0"
"SPA","3/5/2020","0","0","0","0","0","0",,,"0"
"SPA","4/5/2020","0","0","0","0","0","0",,,"0"
"SPA","5/5/2020","0","0","0","0","0","0",,,"0"
"SPA","6/5/2020","0","0","0","0","0","0",,,"0"
"SPA","7/5/2020","0","-890","0","0","0","890",,"-1","0"
"SPA","8/5/2020","0","0","0","0","0","0",,,"0"
"SPA","9/5/2020","0","0","0","0","0","0",,,"0"
"SPA","10/5/2020","0","0","0","0","0","0",,,"0"
"SPA","11/5/2020","0","0","0","0","0","0",,,"0"
"SPA","12/5/2020","0","3190","0","0","0","-3190",,"-1","0"
"SPA","13/5/2020","0","0","0","0","0","0",,,"0"
"SPA","14/5/2020","0","0","0","0","0","0",,,"0"
"SPA","15/5/2020","0","0","0","0","0","0",,,"0"
"SPA","16/5/2020","0","0","0","0","0","0",,,"0"
"SPA","17/5/2020","0","0","0","0","0","0",,,"0"
"SPA","18/5/2020","0","0","0","0","0","0",,,"0"
"SPA","19/5/2020","0","0","0","0","0","0",,,"0"
"SPA","20/5/2020","0","0","0","0","0","0",,,"0"
"SPA","21/5/2020","0","0","0","0","0","0",,,"0"
"SPA","22/5/2020","0","0","0","0","0","0",,,"0"
"SPA","23/5/2020","0","0","0","0","0","0",,,"0"
"SPA","24/5/2020","0","0","0","0","0","0",,,"0"
"SPA","25/5/2020","0","0","0","0","0","0",,,"0"
"SPA","26/5/2020","0","0","0","0","0","0",,,"0"
"SPA","27/5/2020","0","0","0","0","0","0",,,"0"
"SPA","28/5/2020","0","0","0","0","0","0",,,"0"
"SPA","29/5/2020","0","0","0","0","0","0",,,"0"
"SPA","30/5/2020","0","0","0","0","0","0",,,"0"
"SPA","31/5/2020","0","0","0","0","0","0",,,"0"
"SPA","1/6/2020","0","0","0","0","0","0",,,"0"
"SPA","2/6/2020","0","0","0","0","0","0",,,"0"
"SPA","3/6/2020","0","0","0","0","0","0",,,"0"
"SPA","4/6/2020","0","0","0","0","0","0",,,"0"
"SPA","5/6/2020","0","0","0","0","0","0",,,"0"
"SPA","6/6/2020","0","0","0","0","0","0",,,"0"
"SPA","7/6/2020","0","0","0","0","0","0",,,"0"
"SPA","8/6/2020","0","0","0","0","0","0",,,"0"
"SPA","9/6/2020","0","0","0","0","0","0",,,"0"
"SPA","10/6/2020","0","0","0","0","0","0",,,"0"
"SPA","11/6/2020","0","0","0","0","0","0",,,"0"
"SPA","12/6/2020","0","0","0","0","0","0",,,"0"
"SPA","13/6/2020","0","0","0","0","0","0",,,"0"
"SPA","14/6/2020","0","0","0","0","0","0",,,"0"
"SPA","15/6/2020","0","0","0","0","0","0",,,"0"
"SPA","16/6/2020","0","0","0","0","0","0",,,"0"
"SPA","17/6/2020","0","0","0","0","0","0",,,"0"
"SPA","18/6/2020","0","0","0","0","0","0",,,"0"
"SPA","19/6/2020","0","0","0","0","0","0",,,"0"
"SPA","20/6/2020","0","0","0","0","0","0",,,"0"
"SPA","21/6/2020","0","0","0","0","0","0",,,"0"
"SPA","22/6/2020","0","0","0","0","0","0",,,"0"
"SPA","23/6/2020","0","0","0","0","0","0",,,"0"
"SPA","24/6/2020","0","0","0","0","0","0",,,"0"
"SPA","25/6/2020","0","0","0","0","0","0",,,"0"
"SPA","26/6/2020","0","0","0","0","0","0",,,"0"
"SPA","27/6/2020","0","0","0","0","0","0",,,"0"
"SPA","28/6/2020","0","0","0","0","0","0",,,"0"
"SPA","29/6/2020","0","0","0","0","0","0",,,"0"
"SPA","30/6/2020","0","0","0","0","0","0",,,"0"
"SPA","1/7/2020","0","0","0","0","0","0",,,"0"
"SPA","2/7/2020","0","0","0","0","0","0",,,"0"
"SPA","3/7/2020","0","0","0","0","0","0",,,"0"
"SPA","4/7/2020","0","0","0","0","0","0",,,"0"
"SPA","5/7/2020","0","0","0","0","0","0",,,"0"
"SPA","6/7/2020","0","0","0","0","0","0",,,"0"
"SPA","7/7/2020","0","0","0","0","0","0",,,"0"
"SPA","8/7/2020","0","0","0","0","0","0",,,"0"
"SPA","9/7/2020","0","0","0","0","0","0",,,"0"
"SPA","10/7/2020","0","0","0","0","0","0",,,"0"
"SPA","11/7/2020","0","0","0","0","0","0",,,"0"
"SPA","12/7/2020","0","0","0","0","0","0",,,"0"
"SPA","13/7/2020","0","0","0","0","0","0",,,"0"
"SPA","14/7/2020","0","0","0","0","0","0",,,"0"
"SPA","15/7/2020","0","0","0","0","0","0",,,"0"
"SPA","16/7/2020","0","0","0","0","0","0",,,"0"
"SPA","17/7/2020","0","0","0","0","0","0",,,"0"
"SPA","18/7/2020","0","0","0","0","0","0",,,"0"
"SPA","19/7/2020","0","0","0","0","0","0",,,"0"
"SPA","20/7/2020","0","0","0","0","0","0",,,"0"
"SPA","21/7/2020","0","0","0","0","0","0",,,"0"
"SPA","22/7/2020","0","0","0","0","0","0",,,"0"
"SPA","23/7/2020","0","0","0","0","0","0",,,"0"
"SPA","24/7/2020","0","0","0","0","0","0",,,"0"
"SPA","25/7/2020","0","0","0","0","0","0",,,"0"
"SPA","26/7/2020","0","0","0","0","0","0",,,"0"
"SPA","27/7/2020","0","0","0","0","0","0",,,"0"
"SPA","28/7/2020","0","0","0","0","0","0",,,"0"
"SPA","29/7/2020","0","0","0","0","0","0",,,"0"
"SPA","30/7/2020","0","0","0","0","0","0",,,"0"
"SPA","31/7/2020","0","0","0","0","0","0",,,"0"
"SPA","1/8/2020","0","0","0","0","0","0",,,"0"
"SPA","2/8/2020","0","0","0","0","0","0",,,"0"
"SPA","3/8/2020","0","0","0","0","0","0",,,"0"
"SPA","4/8/2020","0","0","0","0","0","0",,,"0"
"SPA","5/8/2020","0","0","0","0","0","0",,,"0"
"SPA","6/8/2020","0","0","0","0","0","0",,,"0"
"SPA","7/8/2020","0","0","0","0","0","0",,,"0"
"SPA","8/8/2020","0","0","0","0","0","0",,,"0"
"SPA","9/8/2020","0","0","0","0","0","0",,,"0"
"SPA","10/8/2020","0","0","0","0","0","0",,,"0"
"SPA","11/8/2020","0","0","0","0","0","0",,,"0"
"SPA","12/8/2020","0","0","0","0","0","0",,,"0"
"SPA","13/8/2020","0","0","0","0","0","0",,,"0"
"SPA","14/8/2020","0","0","0","0","0","0",,,"0"
"SPA","15/8/2020","0","0","0","0","0","0",,,"0"
"SPA","16/8/2020","0","0","0","0","0","0",,,"0"
"SPA","17/8/2020","0","0","0","0","0","0",,,"0"
"SPA","18/8/2020","0","0","0","0","0","0",,,"0"
"SPA","19/8/2020","0","0","0","0","0","0",,,"0"
"SPA","20/8/2020","0","0","0","0","0","0",,,"0"
"SPA","21/8/2020","0","0","0","0","0","0",,,"0"
"SPA","22/8/2020","0","0","0","0","0","0",,,"0"
"SPA","23/8/2020","0","0","0","0","0","0",,,"0"
"SPA","24/8/2020","0","0","0","0","0","0",,,"0"
"SPA","25/8/2020","0","0","0","0","0","0",,,"0"
"SPA","26/8/2020","0","0","0","0","0","0",,,"0"
"SPA","27/8/2020","0","0","0","0","0","0",,,"0"
"SPA","28/8/2020","0","0","0","0","0","0",,,"0"
"SPA","29/8/2020","0","0","0","0","0","0",,,"0"
"SPA","30/8/2020","0","0","0","0","0","0",,,"0"
"SPA","31/8/2020","0","0","0","0","0","0",,,"0"
"SPA","1/9/2020","0","0","0","0","0","0",,,"0"
"SPA","2/9/2020","0","0","0","0","0","0",,,"0"
"SPA","3/9/2020","0","0","0","0","0","0",,,"0"
"SPA","4/9/2020","0","0","0","0","0","0",,,"0"
"SPA","5/9/2020","0","0","0","0","0","0",,,"0"
"SPA","6/9/2020","0","0","0","0","0","0",,,"0"
"SPA","7/9/2020","0","0","0","0","0","0",,,"0"
"SPA","8/9/2020","0","0","0","0","0","0",,,"0"
"SPA","9/9/2020","0","0","0","0","0","0",,,"0"
"SPA","10/9/2020","0","0","0","0","0","0",,,"0"
"SPA","11/9/2020","0","0","0","0","0","0",,,"0"
"SPA","12/9/2020","0","0","0","0","0","0",,,"0"
"SPA","13/9/2020","0","0","0","0","0","0",,,"0"
"SPA","14/9/2020","0","0","0","0","0","0",,,"0"
"SPA","15/9/2020","0","0","0","0","0","0",,,"0"
"SPA","16/9/2020","0","0","0","0","0","0",,,"0"
"SPA","17/9/2020","0","0","0","0","0","0",,,"0"
"SPA","18/9/2020","0","0","0","0","0","0",,,"0"
"SPA","19/9/2020","0","0","0","0","0","0",,,"0"
"SPA","20/9/2020","0","0","0","0","0","0",,,"0"
"SPA","21/9/2020","0","0","0","0","0","0",,,"0"
"SPA","22/9/2020","0","0","0","0","0","0",,,"0"
"SPA","23/9/2020","0","0","0","0","0","0",,,"0"
"SPA","24/9/2020","0","0","0","0","0","0",,,"0"
"SPA","25/9/2020","1","769","1","1369","0","600","0","0.7802340702210663","0"
"SPA","26/9/2020","1","889","1","1369","0","480","0","0.5399325084364455","0"
"SPA","27/9/2020","2","1172","2","1664","0","492","0","0.4197952218430034","0"
"SPA","28/9/2020","3","1070","3","1842","0","772","0","0.7214953271028037","0"
"SPA","29/9/2020","5","2210","5","2942","0","732","0","0.33122171945701356","0"
"SPA","30/9/2020","5","2210","5","2942","0","732","0","0.33122171945701356","0"
"SPA","1/10/2020","3","1152","3","211363","0","210211","0","182.47482638888889","0"
"SPA","2/10/2020","9","2081","9","542329","0","540248","0","259.60980297933685","0"
"SPA","3/10/2020","13","973","13","541341","0","540368","0","555.3627954779034","0"
"SPA","4/10/2020","8","560","8","920","0","360","0","0.6428571428571429","0"
"SPA","5/10/2020","3","680","3","920","0","240","0","0.35294117647058826","0"
"SPA","6/10/2020","3","680","3","920","0","240","0","0.35294117647058826","0"
"SPA","7/10/2020","2","680","2","920","0","240","0","0.35294117647058826","0"
"SPA","8/10/2020","4","767","4","405903","0","405136","0","528.2086049543676","0"
"SPA","9/10/2020","11","1736","11","407399","0","405663","0","233.67684331797236","0"
"SPA","10/10/2020","33","1473","10","406976","-23","405503","-0.696969696","275.29056347589955","1"
"SPA","11/10/2020","2","620","2","668","0","48","0","0.07741935483870968","0"
"SPA","12/10/2020","0","0","0","0","0","0",,,"0"
"SPA","13/10/2020","0","0","0","0","0","0",,,"0"
"SPA","14/10/2020","0","0","0","0","0","0",,,"0"
"SPA","15/10/2020","18","3896","18","741219","0","737323","0","189.25128336755648","0"
"SPA","16/10/2020","24","4797","24","1026552","0","1021755","0","212.99874921826142","0"
"SPA","17/10/2020","49","13136","19","1026501","-30","1013365","-0.612244897","77.1441077953715","1"
"SPA","18/10/2020","37","10203","7","542180","-30","531977","-0.81081081","52.13927276291287","1"
"SPA","19/10/2020","44","9914","5","101780","-39","91866","-0.886363636","9.266290094815412","1"
"SPA","20/10/2020","43","6427","6","467789","-37","461362","-0.860465116","71.78496965925004","1"
"SPA","21/10/2020","17","2174","9","468498","-8","466324","-0.470588235","214.50045998160073","1"
"SPA","22/10/2020","27","6105","8","618109","-19","612004","-0.703703703","100.24635544635545","1"
"SPA","23/10/2020","19","6105","8","618109","-11","612004","-0.578947368","100.24635544635545","1"
"SPA","24/10/2020","58","16604","2","2568","-56","-14036","-0.965517241","-0.8453384726571911","1"
"SPA","25/10/2020","14","6118","7","5200","-7","-918","-0.5","-0.15004903563255967","1"
"SPA","26/10/2020","14","6263","7","5105","-7","-1158","-0.5","-0.1848954175315344","1"
"SPA","27/10/2020","12","4278","5","2137","-7","-2141","-0.583333333","-0.5004675081813932","1"
"SPA","28/10/2020","15","5426","2","565","-13","-4861","-0.866666666","-0.8958717287136012","1"
"SPA","29/10/2020","20","6442","7","241369","-13","234927","-0.65","36.468022353306424","1"
"SPA","30/10/2020","22","5539","9","240915","-13","235376","-0.59090909","42.49431305289764","1"
"SPA","31/10/2020","51","6475","13","240565","-38","234090","-0.745098039","36.15289575289575","1"
"SPA","1/11/2020","46","7689","8","2765","-38","-4924","-0.826086956","-0.640395370009104","1"
"SPA","2/11/2020","34","7651","4","4322","-30","-3329","-0.882352941","-0.43510652202326494","1"
"SPA","3/11/2020","24","7771","4","4322","-20","-3449","-0.833333333","-0.4438296229571484","1"
"SPA","4/11/2020","6","3934","6","5887","0","1953","0","0.49644128113879005","0"
"SPA","5/11/2020","12","1964","4","2516","-8","552","-0.666666666","0.28105906313645623","1"
"SPA","6/11/2020","60","4071","12","912018","-48","907947","-0.8","223.02800294767871","1"
"SPA","7/11/2020","60","4482","12","912018","-48","907536","-0.8","202.48460508701473","1"
"SPA","8/11/2020","55","4799","7","912011","-48","907212","-0.872727272","189.04188372577622","1"
"SPA","9/11/2020","42","2089","2","2989","-40","900","-0.952380952","0.430828147438966","1"
"SPA","10/11/2020","13","5658","4","3938","-9","-1720","-0.692307692","-0.303994344291269","1"
"SPA","11/11/2020","26","12142","4","3938","-22","-8204","-0.846153846","-0.6756712238510953","1"
"SPA","12/11/2020","18","9619","5","4679","-13","-4940","-0.722222222","-0.5135668988460339","1"
"SPA","13/11/2020","20","8572","7","4092","-13","-4480","-0.65","-0.5226318245450303","1"
"SPA","14/11/2020","22","5121","12","7318","-10","2197","-0.454545454","0.42901776996680335","1"
"SPA","15/11/2020","21","7211","11","9000","-10","1789","-0.476190476","0.24809319095825821","1"
"SPA","16/11/2020","16","3754","6","5182","-10","1428","-0.625","0.3803942461374534","1"
"SPA","17/11/2020","48","18712","4","3564","-44","-15148","-0.916666666","-0.8095339888841385","1"
"SPA","18/11/2020","30","9356","6","4124","-24","-5232","-0.8","-0.5592133390337751","1"
"SPA","19/11/2020","30","9374","6","4142","-24","-5232","-0.8","-0.5581395348837209","1"
"SPA","20/11/2020","54","8782","8","3750","-46","-5032","-0.851851851","-0.572990207242086","1"
"SPA","21/11/2020","56","11104","14","6281","-42","-4823","-0.75","-0.4343479827089337","1"
"SPA","22/11/2020","49","9716","7","3305","-42","-6411","-0.857142857","-0.6598394400988061","1"
"SPA","23/11/2020","20","4914","0","0","-20","-4914","-1","-1","1"
"SPA","24/11/2020","33","9409","4","3471","-29","-5938","-0.878787878","-0.6310978850037199","1"
"SPA","25/11/2020","17","6717","8","5460","-9","-1257","-0.529411764","-0.18713711478338543","1"
"SPA","26/11/2020","20","8342","12","1091031","-8","1082689","-0.4","129.78770079117717","1"
"SPA","27/11/2020","23","7722","15","1090330","-8","1082608","-0.347826086","140.19787619787618","1"
"SPA","28/11/2020","28","8760","20","1090157","-8","1081397","-0.285714285","123.44714611872146","1"
"SPA","29/11/2020","19","7205","9","7042","-10","-163","-0.526315789","-0.02262317834836919","1"
"SPA","30/11/2020","17","6379","7","5415","-10","-964","-0.588235294","-0.1511208653393949","1"
"SPA","1/12/2020","8","2479","7","3159","-1","680","-0.125","0.2743041549011698","1"
"SPA","2/12/2020","8","2261","7","3639","-1","1378","-0.125","0.6094648385670057","1"
"SPA","3/12/2020","9","3542","9","6452","0","2910","0","0.8215697346132129","0"
"SPA","4/12/2020","17","7179","15","8296","-2","1117","-0.117647058","0.15559270093327762","1"
"SPA","5/12/2020","32","10077","10","106104","-22","96027","-0.6875","9.529324203632033","1"
"SPA","6/12/2020","54","17540","5","102170","-49","84630","-0.907407407","4.82497149372862","1"
"SPA","7/12/2020","51","16611","4","103082","-47","86471","-0.921568627","5.2056468605141175","1"
"SPA","8/12/2020","52","17618","3","2979","-49","-14639","-0.942307692","-0.8309115677148371","1"
"SPA","9/12/2020","48","20239","6","103836","-42","83597","-0.875","4.130490636889174","1"
"SPA","10/12/2020","47","19496","5","102589","-42","83093","-0.893617021","4.262053754616332","1"
"SPA","11/12/2020","51","20027","9","104371","-42","84344","-0.823529411","4.211514455485095","1"
"SPA","12/12/2020","8","2697","8","104089","0","101392","0","37.594364108268444","0"
"SPA","13/12/2020","5","2807","5","3397","0","590","0","0.2101888136800855","0"
"SPA","14/12/2020","5","2392","5","2903","0","511","0","0.21362876254180602","0"
"SPA","15/12/2020","10","6305","10","4660","0","-1645","0","-0.26090404440919907","0"
"SPA","16/12/2020","42","12428","9","2980","-33","-9448","-0.785714285","-0.7602188606372707","1"
"SPA","17/12/2020","44","13527","11","4511","-33","-9016","-0.75","-0.6665188142234051","1"
"SPA","18/12/2020","44","10043","11","6055","-33","-3988","-0.75","-0.3970925022403664","1"
"SPA","19/12/2020","52","10925","12","9800","-40","-1125","-0.769230769","-0.10297482837528604","1"
"SPA","20/12/2020","37","13316","7","8147","-30","-5169","-0.81081081","-0.38817963352358065","1"
"SPA","21/12/2020","40","23394","10","19036","-30","-4358","-0.75","-0.18628708215781825","1"
"SPA","22/12/2020","44","40416","13","25050","-31","-15366","-0.704545454","-0.3801959619952494","1"
"SPA","23/12/2020","26","35675","15","29903","-11","-5772","-0.423076923","-0.16179397337070778","1"
"SPA","24/12/2020","42","43099","31","47963","-11","4864","-0.261904761","0.11285644678530825","1"
"SPA","25/12/2020","31","32739","31","46627","0","13888","0","0.4242035492837289","0"
"SPA","26/12/2020","34","43326","34","52944","0","9618","0","0.22199141393158842","0"
"SPA","27/12/2020","28","30417","28","37871","0","7454","0","0.24506032810599335","0"
"SPA","28/12/2020","32","24805","23","30016","-9","5211","-0.28125","0.21007861318282603","1"
"SPA","29/12/2020","41","36782","32","39732","-9","2950","-0.219512195","0.08020227285085096","1"
"SPA","30/12/2020","35","40328","35","45496","0","5168","0","0.12814917675064472","0"
"SPA","31/12/2020","33","32934","33","39382","0","6448","0","0.19578551041476894","0"
"SPA","1/1/2021","29","28459","29","33844","0","5385","0","0.1892195790435363","0"
"SPA","2/1/2021","4","4110","4","6255","0","2145","0","0.5218978102189781","0"
"SPA","3/1/2021","3","4072","3","5812","0","1740","0","0.42730844793713163","0"
"SPA","4/1/2021","5","6789","5","9249","0","2460","0","0.3623508616880248","0"
"SPA","5/1/2021","5","4527","5","9249","0","4722","0","1.0430748840291584","0"
"SPA","6/1/2021","5","4527","5","9249","0","4722","0","1.0430748840291584","0"
"SPA","7/1/2021","7","5048","7","8297","0","3249","0","0.643621236133122","0"
"SPA","8/1/2021","8","2709","8","3161","0","452","0","0.16685123661867848","0"
"SPA","9/1/2021","27","2849","8","4297","-19","1448","-0.703703703","0.5082485082485082","1"
"SPA","10/1/2021","30","3560","11","4272","-19","712","-0.633333333","0.2","1"
"SPA","11/1/2021","28","2001","9","2073","-19","72","-0.678571428","0.035982008995502246","1"
"SPA","12/1/2021","26","619","7","643","-19","24","-0.73076923","0.03877221324717286","1"
"SPA","13/1/2021","0","0","0","0","0","0",,,"0"
"SPA","14/1/2021","0","0","0","0","0","0",,,"0"
"SPA","15/1/2021","4","211","4","715","0","504","0","2.3886255924170614","0"
"SPA","16/1/2021","24","1058","5","2162","-19","1104","-0.791666666","1.0434782608695652","1"
"SPA","17/1/2021","30","7097","1","1447","-29","-5650","-0.966666666","-0.7961110328307736","1"
"SPA","18/1/2021","31","7563","2","2073","-29","-5490","-0.93548387","-0.7259024196747322","1"
"SPA","19/1/2021","42","13194","4","2788","-38","-10406","-0.904761904","-0.788691829619524","1"
"SPA","20/1/2021","37","21949","6","4500","-31","-17449","-0.837837837","-0.7949792701262016","1"
"SPA","21/1/2021","18","11607","6","4500","-12","-7107","-0.666666666","-0.6123029206513311","1"
"SPA","22/1/2021","18","8510","6","1287","-12","-7223","-0.666666666","-0.8487661574618096","1"
"SPA","23/1/2021","24","616","5","572","-19","-44","-0.791666666","-0.07142857142857142","1"
"SPA","24/1/2021","34","9242","5","3948","-29","-5294","-0.852941176","-0.5728197359878814","1"
"SPA","25/1/2021","32","8386","3","3376","-29","-5010","-0.90625","-0.597424278559504","1"
"SPA","26/1/2021","21","1289","2","1929","-19","640","-0.904761904","0.4965089216446858","1"
"SPA","27/1/2021","11","5501","2","1929","-9","-3572","-0.818181818","-0.6493364842755862","1"
"SPA","28/1/2021","12","6263","3","3231","-9","-3032","-0.75","-0.48411304486667733","1"
"SPA","29/1/2021","7","1955","7","2915","0","960","0","0.49104859335038364","0"
"SPA","30/1/2021","26","1955","7","2915","-19","960","-0.73076923","0.49104859335038364","1"
"SPA","31/1/2021","21","1394","2","1838","-19","444","-0.904761904","0.31850789096126253","1"
"SPA","1/2/2021","20","512","1","536","-19","24","-0.95","0.046875","1"
"SPA","2/2/2021","31","8865","0","0","-31","-8865","-1","-1","1"
"SPA","3/2/2021","26","17044","2","1216","-24","-15828","-0.923076923","-0.9286552452475945","1"
"SPA","4/2/2021","34","22954","2","1216","-32","-21738","-0.94117647","-0.947024483750109","1"
"SPA","5/2/2021","23","12633","3","0","-20","-12633","-0.869565217","-1","1"
"SPA","6/2/2021","53","6597","5","608","-48","-5989","-0.905660377","-0.9078368955585873","1"
"SPA","7/2/2021","40","0","0","0","-40","0","-1",,"1"
"SPA","8/2/2021","19","0","0","0","-19","0","-1",,"1"
"SPA","9/2/2021","19","0","0","0","-19","0","-1",,"1"
"SPA","10/2/2021","0","0","0","0","0","0",,,"0"
"SPA","11/2/2021","1","698","1","1298","0","600","0","0.8595988538681948","0"
"SPA","12/2/2021","4","338","4","1298","0","960","0","2.8402366863905324","0"
"SPA","13/2/2021","22","-480","3","0","-19","480","-0.863636363","-1","1"
"SPA","14/2/2021","32","8155","3","835","-29","-7320","-0.90625","-0.897608828939301","1"
"SPA","15/2/2021","29","6130","0","0","-29","-6130","-1","-1","1"
"SPA","16/2/2021","28","4212","0","0","-28","-4212","-1","-1","1"
"SPA","17/2/2021","21","11415","0","0","-21","-11415","-1","-1","1"
"SPA","18/2/2021","15","8687","3","1216","-12","-7471","-0.8","-0.860020720617014","1"
"SPA","19/2/2021","21","11744","9","2051","-12","-9693","-0.571428571","-0.8253576294277929","1"
"SPA","20/2/2021","25","1545","6","835","-19","-710","-0.76","-0.459546925566343","1"
"SPA","21/2/2021","42","6464","2","1041600","-40","1035136","-0.952380952","160.13861386138615","1"
"SPA","22/2/2021","42","6658","2","1041600","-40","1034942","-0.952380952","155.4433763893061","1"
"SPA","23/2/2021","39","4212","0","0","-39","-4212","-1","-1","1"
"SPA","24/2/2021","22","10815","1","0","-21","-10815","-0.954545454","-1","1"
"SPA","25/2/2021","13","6723","1","0","-12","-6723","-0.923076923","-1","1"
"SPA","26/2/2021","16","6243","4","0","-12","-6243","-0.75","-1","1"
"SPA","27/2/2021","53","-480","3","0","-50","480","-0.943396226","-1","1"
"SPA","28/2/2021","57","5161","0","0","-57","-5161","-1","-1","1"
"SPA","1/3/2021","39","3730","0","0","-39","-3730","-1","-1","1"
"SPA","2/3/2021","19","0","0","0","-19","0","-1",,"1"
"SPA","3/3/2021","25","0","0","0","-25","0","-1",,"1"
"SPA","4/3/2021","25","0","0","0","-25","0","-1",,"1"
"SPA","5/3/2021","31","1026","5","2390","-26","1364","-0.838709677","1.3294346978557505","1"
"SPA","6/3/2021","50","1266","5","2390","-45","1124","-0.9","0.8878357030015798","1"
"SPA","7/3/2021","47","2083","3","2465","-44","382","-0.936170212","0.18338934229476717","1"
"SPA","8/3/2021","47","2323","3","2465","-44","142","-0.936170212","0.06112785191562634","1"
"SPA","9/3/2021","47","2332","3","2594","-44","262","-0.936170212","0.11234991423670669","1"
"SPA","10/3/2021","39","6228","2","2601","-37","-3627","-0.948717948","-0.5823699421965318","1"
"SPA","11/3/2021","39","6348","2","2601","-37","-3747","-0.948717948","-0.5902646502835539","1"
"SPA","12/3/2021","41","5051","4","1304","-37","-3747","-0.902439024","-0.741833300336567","1"
"SPA","13/3/2021","22","-480","3","0","-19","480","-0.863636363","-1","1"
"SPA","14/3/2021","19","0","0","0","-19","0","-1",,"1"
"SPA","15/3/2021","19","0","0","0","-19","0","-1",,"1"
"SPA","16/3/2021","28","0","0","0","-28","0","-1",,"1"
"SPA","17/3/2021","9","0","0","0","-9","0","-1",,"1"
"SPA","18/3/2021","10","922","1","1522","-9","600","-0.9","0.6507592190889371","1"
"SPA","19/3/2021","13","562","4","1522","-9","960","-0.692307692","1.708185053380783","1"
"SPA","20/3/2021","48","17546","4","1522","-44","-16024","-0.916666666","-0.913256582696911","1"
"SPA","21/3/2021","11","863","1","1758","-10","895","-0.909090909","1.037079953650058","1"
"SPA","22/3/2021","11","1043","1","1758","-10","715","-0.909090909","0.6855225311601151","1"
"SPA","23/3/2021","10","0","0","0","-10","0","-1",,"1"
"SPA","24/3/2021","12","4707","0","0","-12","-4707","-1","-1","1"
"SPA","25/3/2021","14","5372","2","713","-12","-4659","-0.857142857","-0.8672747580044676","1"
"SPA","26/3/2021","18","5367","6","1348","-12","-4019","-0.666666666","-0.7488354760573878","1"
"SPA","27/3/2021","38","1009","7","2667","-31","1658","-0.815789473","1.643211100099108","1"
"SPA","28/3/2021","34","1761","3","3251","-31","1490","-0.911764705","0.8461101646791596","1"
"SPA","29/3/2021","13","1380","3","2430","-10","1050","-0.769230769","0.7608695652173914","1"
"SPA","30/3/2021","5","1763","5","4003","0","2240","0","1.2705615428247305","0"
"SPA","31/3/2021","3","938","3","2048","0","1110","0","1.183368869936034","0"
"SPA","1/4/2021","5","1965","5","3563","0","1598","0","0.8132315521628499","0"
"SPA","2/4/2021","41","3428","11","6610","-30","3182","-0.731707317","0.9282380396732789","1"
"SPA","3/4/2021","34","140","4","1100","-30","960","-0.882352941","6.857142857142857","1"
"SPA","4/4/2021","1","620","1","1100","0","480","0","0.7741935483870968","0"
"SPA","5/4/2021","0","0","0","0","0","0",,,"0"
"SPA","6/4/2021","0","0","0","0","0","0",,,"0"
"SPA","7/4/2021","1","243","1","195075","0","194832","0","801.7777777777778","0"
"SPA","8/4/2021","2","865","2","196297","0","195432","0","225.9329479768786","0"
"SPA","9/4/2021","7","768","7","196720","0","195952","0","255.14583333333334","0"
"SPA","10/4/2021","7","1247","7","196720","0","195473","0","156.75461106655973","0"
"SPA","11/4/2021","0","0","0","0","0","0",,,"0"
"SPA","12/4/2021","0","0","0","0","0","0",,,"0"
"SPA","13/4/2021","0","0","0","0","0","0",,,"0"
"SPA","14/4/2021","0","0","0","0","0","0",,,"0"
"SPA","15/4/2021","0","0","0","0","0","0",,,"0"
"SPA","16/4/2021","3","-480","3","0","0","480","0","-1","0"
"SPA","17/4/2021","4","-480","4","0","0","480","0","-1","0"
"SPA","18/4/2021","0","0","0","0","0","0",,,"0"
"SPA","19/4/2021","0","0","0","0","0","0",,,"0"
"SPA","20/4/2021","0","0","0","0","0","0",,,"0"
"SPA","21/4/2021","0","0","0","0","0","0",,,"0"
"SPA","22/4/2021","0","0","0","0","0","0",,,"0"
"SPA","23/4/2021","3","-480","3","0","0","480","0","-1","0"
"SPA","24/4/2021","24","-480","3","0","-21","480","-0.875","-1","1"
"SPA","25/4/2021","21","0","0","0","-21","0","-1",,"1"
"SPA","26/4/2021","0","0","0","0","0","0",,,"0"
"SPA","27/4/2021","0","0","0","0","0","0",,,"0"
"SPA","28/4/2021","0","0","0","0","0","0",,,"0"
"SPA","29/4/2021","0","0","0","0","0","0",,,"0"
"SPA","30/4/2021","0","0","0","0","0","0",,,"0"
"SPA","1/5/2021","0","0","0","0","0","0",,,"0"
"SPA","2/5/2021","0","0","0","0","0","0",,,"0"
"SPA","3/5/2021","0","0","0","0","0","0",,,"0"
"SPA","4/5/2021","0","0","0","0","0","0",,,"0"
"SPA","5/5/2021","0","0","0","0","0","0",,,"0"
"SPA","6/5/2021","0","0","0","0","0","0",,,"0"
"SPA","7/5/2021","0","0","0","0","0","0",,,"0"
"SPA","8/5/2021","0","0","0","0","0","0",,,"0"
"SPA","9/5/2021","0","0","0","0","0","0",,,"0"
"SPA","10/5/2021","0","0","0","0","0","0",,,"0"
"SPA","11/5/2021","0","0","0","0","0","0",,,"0"
"SPA","12/5/2021","0","0","0","0","0","0",,,"0"
"SPA","13/5/2021","0","0","0","0","0","0",,,"0"
"SPA","14/5/2021","0","0","0","0","0","0",,,"0"
"SPA","15/5/2021","0","0","0","0","0","0",,,"0"
"SPA","16/5/2021","0","0","0","0","0","0",,,"0"
"SPA","17/5/2021","0","0","0","0","0","0",,,"0"
"SPA","18/5/2021","0","0","0","0","0","0",,,"0"
"SPA","19/5/2021","0","0","0","0","0","0",,,"0"
"SPA","20/5/2021","0","0","0","0","0","0",,,"0"
"SPA","21/5/2021","0","0","0","0","0","0",,,"0"
"SPA","22/5/2021","0","0","0","0","0","0",,,"0"
"SPA","23/5/2021","0","0","0","0","0","0",,,"0"
"SPA","24/5/2021","0","0","0","0","0","0",,,"0"
"SPA","25/5/2021","0","0","0","0","0","0",,,"0"
"SPA","26/5/2021","0","0","0","0","0","0",,,"0"
"SPA","27/5/2021","0","0","0","0","0","0",,,"0"
"SPA","28/5/2021","0","0","0","0","0","0",,,"0"
"SPA","29/5/2021","0","0","0","0","0","0",,,"0"
"SPA","30/5/2021","0","0","0","0","0","0",,,"0"
"SPA","31/5/2021","0","0","0","0","0","0",,,"0"
"SPA","1/6/2021","0","0","0","0","0","0",,,"0"
"SPA","2/6/2021","0","0","0","0","0","0",,,"0"
"SPA","3/6/2021","0","0","0","0","0","0",,,"0"
"SPA","4/6/2021","0","0","0","0","0","0",,,"0"
"SPA","5/6/2021","0","0","0","0","0","0",,,"0"
"SPA","6/6/2021","0","0","0","0","0","0",,,"0"
"SPA","7/6/2021","0","0","0","0","0","0",,,"0"
"SPA","8/6/2021","0","0","0","0","0","0",,,"0"
"SPA","9/6/2021","0","0","0","0","0","0",,,"0"
"SPA","10/6/2021","0","0","0","0","0","0",,,"0"
"SPA","11/6/2021","0","0","0","0","0","0",,,"0"
"SPA","12/6/2021","0","0","0","0","0","0",,,"0"
"SPA","13/6/2021","0","0","0","0","0","0",,,"0"
"SPA","14/6/2021","0","0","0","0","0","0",,,"0"
"SPA","15/6/2021","0","0","0","0","0","0",,,"0"
"SPA","16/6/2021","0","0","0","0","0","0",,,"0"
"SPA","17/6/2021","0","0","0","0","0","0",,,"0"
"SPA","18/6/2021","0","0","0","0","0","0",,,"0"
"SPA","19/6/2021","0","0","0","0","0","0",,,"0"
"SPA","20/6/2021","0","0","0","0","0","0",,,"0"
"SPA","21/6/2021","0","0","0","0","0","0",,,"0"
"SPA","22/6/2021","0","0","0","0","0","0",,,"0"
"SPA","23/6/2021","0","0","0","0","0","0",,,"0"
"SPA","24/6/2021","0","0","0","0","0","0",,,"0"
"SPA","25/6/2021","0","0","0","0","0","0",,,"0"
"SPA","26/6/2021","0","0","0","0","0","0",,,"0"
"SPA","27/6/2021","0","0","0","0","0","0",,,"0"
"SPA","28/6/2021","0","0","0","0","0","0",,,"0"
"SPA","29/6/2021","0","0","0","0","0","0",,,"0"
"SPA","30/6/2021","0","0","0","0","0","0",,,"0"
"SPA","1/7/2021","0","0","0","0","0","0",,,"0"
"SPA","2/7/2021","0","0","0","0","0","0",,,"0"
"SPA","3/7/2021","0","0","0","0","0","0",,,"0"
"SPA","4/7/2021","0","0","0","0","0","0",,,"0"
"SPA","5/7/2021","0","0","0","0","0","0",,,"0"
"SPA","6/7/2021","0","0","0","0","0","0",,,"0"
"SPA","7/7/2021","0","0","0","0","0","0",,,"0"
"SPA","8/7/2021","0","0","0","0","0","0",,,"0"
"SPA","9/7/2021","0","0","0","0","0","0",,,"0"
"SPA","10/7/2021","0","0","0","0","0","0",,,"0"
"SPA","11/7/2021","0","0","0","0","0","0",,,"0"
"SPA","12/7/2021","0","0","0","0","0","0",,,"0"
"SPA","13/7/2021","0","0","0","0","0","0",,,"0"
"SPA","14/7/2021","0","0","0","0","0","0",,,"0"
"SPA","15/7/2021","0","0","0","0","0","0",,,"0"
"SPA","16/7/2021","0","0","0","0","0","0",,,"0"
"SPA","17/7/2021","0","0","0","0","0","0",,,"0"
"SPA","18/7/2021","0","0","0","0","0","0",,,"0"
"SPA","19/7/2021","0","0","0","0","0","0",,,"0"
"SPA","20/7/2021","0","0","0","0","0","0",,,"0"
"SPA","21/7/2021","0","0","0","0","0","0",,,"0"
"SPA","22/7/2021","0","0","0","0","0","0",,,"0"
"SPA","23/7/2021","0","0","0","0","0","0",,,"0"
"SPA","24/7/2021","0","0","0","0","0","0",,,"0"
"SPA","25/7/2021","0","0","0","0","0","0",,,"0"
"SPA","26/7/2021","0","0","0","0","0","0",,,"0"
"SPA","27/7/2021","0","0","0","0","0","0",,,"0"
"SPA","28/7/2021","0","0","0","0","0","0",,,"0"
"SPA","29/7/2021","0","0","0","0","0","0",,,"0"
"SPA","30/7/2021","0","0","0","0","0","0",,,"0"
"SPA","31/7/2021","0","0","0","0","0","0",,,"0"
"SPA","1/8/2021","0","0","0","0","0","0",,,"0"
"SPA","2/8/2021","0","0","0","0","0","0",,,"0"
"SPA","3/8/2021","0","0","0","0","0","0",,,"0"
"SPA","4/8/2021","0","0","0","0","0","0",,,"0"
"SPA","5/8/2021","0","0","0","0","0","0",,,"0"
"SPA","6/8/2021","0","0","0","0","0","0",,,"0"
"SPA","7/8/2021","0","0","0","0","0","0",,,"0"
"SPA","8/8/2021","0","0","0","0","0","0",,,"0"
"SPA","9/8/2021","0","0","0","0","0","0",,,"0"
"SPA","10/8/2021","0","0","0","0","0","0",,,"0"
"SPA","11/8/2021","0","0","0","0","0","0",,,"0"
"SPA","12/8/2021","0","0","0","0","0","0",,,"0"
"SPA","13/8/2021","0","0","0","0","0","0",,,"0"
"SPA","14/8/2021","0","0","0","0","0","0",,,"0"
"SPA","15/8/2021","0","0","0","0","0","0",,,"0"
"SPA","16/8/2021","0","0","0","0","0","0",,,"0"
"SPA","17/8/2021","0","0","0","0","0","0",,,"0"
"SPA","18/8/2021","0","0","0","0","0","0",,,"0"
"SPA","19/8/2021","0","0","0","0","0","0",,,"0"
"SPA","20/8/2021","0","0","0","0","0","0",,,"0"
"SPA","21/8/2021","0","0","0","0","0","0",,,"0"
"SPA","22/8/2021","0","0","0","0","0","0",,,"0"
"SPA","23/8/2021","0","0","0","0","0","0",,,"0"
"SPA","24/8/2021","0","0","0","0","0","0",,,"0"
"SPA","25/8/2021","0","0","0","0","0","0",,,"0"
"SPA","26/8/2021","0","0","0","0","0","0",,,"0"
"SPA","27/8/2021","0","0","0","0","0","0",,,"0"
"SPA","28/8/2021","0","0","0","0","0","0",,,"0"
"SPA","29/8/2021","0","0","0","0","0","0",,,"0"
"SPA","30/8/2021","0","0","0","0","0","0",,,"0"
"SPA","31/8/2021","0","0","0","0","0","0",,,"0"
"SPA","1/9/2021","0","0","0","0","0","0",,,"0"
"SPA","2/9/2021","0","0","0","0","0","0",,,"0"
"SPA","3/9/2021","0","0","0","0","0","0",,,"0"
"SPA","4/9/2021","0","0","0","0","0","0",,,"0"
"SPA","5/9/2021","0","0","0","0","0","0",,,"0"
"SPA","6/9/2021","0","0","0","0","0","0",,,"0"
"SPA","7/9/2021","0","0","0","0","0","0",,,"0"
"SPA","8/9/2021","0","0","0","0","0","0",,,"0"
"SPA","9/9/2021","0","0","0","0","0","0",,,"0"
"SPA","10/9/2021","0","0","0","0","0","0",,,"0"
"SPA","11/9/2021","0","0","0","0","0","0",,,"0"
"SPA","12/9/2021","0","0","0","0","0","0",,,"0"
"SPA","13/9/2021","0","0","0","0","0","0",,,"0"
"SPA","14/9/2021","0","0","0","0","0","0",,,"0"
"SPA","15/9/2021","0","0","0","0","0","0",,,"0"
"SPA","16/9/2021","0","0","0","0","0","0",,,"0"
"SPA","17/9/2021","0","0","0","0","0","0",,,"0"
"SPA","18/9/2021","0","0","0","0","0","0",,,"0"
"SPA","19/9/2021","0","0","0","0","0","0",,,"0"
"SPA","20/9/2021","0","0","0","0","0","0",,,"0"
"SPA","21/9/2021","0","0","0","0","0","0",,,"0"
"SPA","22/9/2021","0","0","0","0","0","0",,,"0"
"SPA","23/9/2021","0","0","0","0","0","0",,,"0"
"SPA","24/9/2021","0","0","0","0","0","0",,,"0"
"SPA","25/9/2021","0","0","0","0","0","0",,,"0"
"SPA","26/9/2021","0","0","0","0","0","0",,,"0"
"SPA","27/9/2021","0","0","0","0","0","0",,,"0"
"SPA","28/9/2021","0","0","0","0","0","0",,,"0"
"SPA","29/9/2021","0","0","0","0","0","0",,,"0"
"SPA","30/9/2021","0","0","0","0","0","0",,,"0"
"SPA","1/10/2021","0","0","0","0","0","0",,,"0"
"SPA","2/10/2021","21","0","0","0","-21","0","-1",,"1"
"SPA","3/10/2021","21","0","0","0","-21","0","-1",,"1"
"SPA","4/10/2021","0","0","0","0","0","0",,,"0"
"SPA","5/10/2021","0","0","0","0","0","0",,,"0"
"SPA","6/10/2021","0","0","0","0","0","0",,,"0"
"SPA","7/10/2021","0","0","0","0","0","0",,,"0"
"SPA","8/10/2021","0","0","0","0","0","0",,,"0"
"SPA","9/10/2021","8","0","0","0","-8","0","-1",,"1"
"SPA","10/10/2021","57","0","0","0","-57","0","-1",,"1"
"SPA","11/10/2021","57","0","0","0","-57","0","-1",,"1"
"SPA","12/10/2021","57","0","0","0","-57","0","-1",,"1"
"SPA","13/10/2021","57","0","0","0","-57","0","-1",,"1"
"SPA","14/10/2021","18","0","0","0","-18","0","-1",,"1"
"SPA","15/10/2021","10","0","0","0","-10","0","-1",,"1"
"SPA","16/10/2021","50","0","0","0","-50","0","-1",,"1"
"SPA","17/10/2021","40","0","0","0","-40","0","-1",,"1"
"SPA","18/10/2021","19","0","0","0","-19","0","-1",,"1"
"SPA","19/10/2021","29","0","0","0","-29","0","-1",,"1"
"SPA","20/10/2021","10","0","0","0","-10","0","-1",,"1"
"SPA","21/10/2021","10","0","0","0","-10","0","-1",,"1"
"SPA","22/10/2021","2","960","2","480","0","-480","0","-0.5","0"
"SPA","23/10/2021","33","960","2","480","-31","-480","-0.939393939","-0.5","1"
"SPA","24/10/2021","33","960","2","480","-31","-480","-0.939393939","-0.5","1"
"SPA","25/10/2021","12","960","2","480","-10","-480","-0.833333333","-0.5","1"
"SPA","26/10/2021","0","0","0","0","0","0",,,"0"
"SPA","27/10/2021","12","0","0","0","-12","0","-1",,"1"
"SPA","28/10/2021","12","0","0","0","-12","0","-1",,"1"
"SPA","29/10/2021","12","0","0","0","-12","0","-1",,"1"
"SPA","30/10/2021","40","0","0","0","-40","0","-1",,"1"
"SPA","31/10/2021","40","0","0","0","-40","0","-1",,"1"
"SPA","1/11/2021","19","0","0","0","-19","0","-1",,"1"
"SPA","2/11/2021","19","0","0","0","-19","0","-1",,"1"
"SPA","3/11/2021","0","0","0","0","0","0",,,"0"
"SPA","4/11/2021","0","0","0","0","0","0",,,"0"
"SPA","5/11/2021","0","0","0","0","0","0",,,"0"
"SPA","6/11/2021","10","0","0","0","-10","0","-1",,"1"
"SPA","7/11/2021","19","0","0","0","-19","0","-1",,"1"
"SPA","8/11/2021","19","0","0","0","-19","0","-1",,"1"
"SPA","9/11/2021","0","0","0","0","0","0",,,"0"
"SPA","10/11/2021","12","0","0","0","-12","0","-1",,"1"
"SPA","11/11/2021","12","0","0","0","-12","0","-1",,"1"
"SPA","12/11/2021","13","1362","1","1362","-12","0","-0.923076923","0","1"
"SPA","13/11/2021","22","1362","1","1362","-21","0","-0.954545454","0","1"
"SPA","14/11/2021","23","2677","1","1362","-22","-1315","-0.956521739","-0.49122151662308555","1"
"SPA","15/11/2021","1","1315","0","0","-1","-1315","-1","-1","1"
"SPA","16/11/2021","0","0","0","0","0","0",,,"0"
"SPA","17/11/2021","0","0","0","0","0","0",,,"0"
"SPA","18/11/2021","0","0","0","0","0","0",,,"0"
"SPA","19/11/2021","0","0","0","0","0","0",,,"0"
"SPA","20/11/2021","19","0","0","0","-19","0","-1",,"1"
"SPA","21/11/2021","19","0","0","0","-19","0","-1",,"1"
"SPA","22/11/2021","19","0","0","0","-19","0","-1",,"1"
"SPA","23/11/2021","28","0","0","0","-28","0","-1",,"1"
"SPA","24/11/2021","9","0","0","0","-9","0","-1",,"1"
"SPA","25/11/2021","0","0","0","0","0","0",,,"0"
"SPA","26/11/2021","0","0","0","0","0","0",,,"0"
"SPA","27/11/2021","21","0","0","0","-21","0","-1",,"1"
"SPA","28/11/2021","21","0","0","0","-21","0","-1",,"1"
"SPA","29/11/2021","0","0","0","0","0","0",,,"0"
"SPA","30/11/2021","9","0","0","0","-9","0","-1",,"1"
"SPA","1/12/2021","9","0","0","0","-9","0","-1",,"1"
"SPA","2/12/2021","0","0","0","0","0","0",,,"0"
"SPA","3/12/2021","0","0","0","0","0","0",,,"0"
"SPA","4/12/2021","19","0","0","0","-19","0","-1",,"1"
"SPA","5/12/2021","19","0","0","0","-19","0","-1",,"1"
"SPA","6/12/2021","19","0","0","0","-19","0","-1",,"1"
"SPA","7/12/2021","20","839","1","839","-19","0","-0.95","0","1"
"SPA","8/12/2021","13","839","1","839","-12","0","-0.923076923","0","1"
"SPA","9/12/2021","13","839","1","839","-12","0","-0.923076923","0","1"
"SPA","10/12/2021","12","0","0","0","-12","0","-1",,"1"
"SPA","11/12/2021","0","0","0","0","0","0",,,"0"
"SPA","12/12/2021","12","0","0","0","-12","0","-1",,"1"
"SPA","13/12/2021","19","0","0","0","-19","0","-1",,"1"
"SPA","14/12/2021","7","0","0","0","-7","0","-1",,"1"
"SPA","15/12/2021","7","0","0","0","-7","0","-1",,"1"
"SPA","16/12/2021","7","0","0","0","-7","0","-1",,"1"
"SPA","17/12/2021","0","0","0","0","0","0",,,"0"
"SPA","18/12/2021","40","0","0","0","-40","0","-1",,"1"
"SPA","19/12/2021","40","0","0","0","-40","0","-1",,"1"
"SPA","20/12/2021","19","0","0","0","-19","0","-1",,"1"
"SPA","21/12/2021","19","0","0","0","-19","0","-1",,"1"
"SPA","22/12/2021","0","0","0","0","0","0",,,"0"
"SPA","23/12/2021","0","0","0","0","0","0",,,"0"
"SPA","24/12/2021","0","0","0","0","0","0",,,"0"
"SPA","25/12/2021","1","2006","1","2006","0","0","0","0","0"
"SPA","26/12/2021","27","6219","3","6219","-24","0","-0.888888888","0","1"
"SPA","27/12/2021","26","4213","2","4213","-24","0","-0.923076923","0","1"
"SPA","28/12/2021","26","3216","2","3216","-24","0","-0.923076923","0","1"
"SPA","29/12/2021","23","3216","2","3216","-21","0","-0.913043478","0","1"
"SPA","30/12/2021","21","0","0","0","-21","0","-1",,"1"
"SPA","31/12/2021","12","0","0","0","-12","0","-1",,"1"
